30 30
1031 1032 1031 1032 1031 1032 1031 1032 1031 1032 1031 1032 1031 1032 1033 1031 1032 1031 1032 1031 1032 1034 1032 1031 1032 1031 1032 1031 1032 1033
91 92 93 92 93 92 93 92 93 92 93 92 93 92 1035 91 92 93 92 93 92 1036 94 93 92 93 92 93 92 1035
95 96 97 98 99 100 101 102 101 102 101 102 101 102 1037 95 96 101 102 103 104 1038 105 101 102 97 98 99 100 1037
106 107 108 109 110 111 112 113 114 115 116 117 118 119 1038 106 107 120 119 121 122 1034 123 124 125 108 126 110 111 1038
106 127 128 110 110 129 130 131 132 133 110 110 134 135 1033 106 127 136 137 118 138 1036 123 139 140 128 110 110 129 1033
106 141 142 143 144 145 146 147 148 110 110 110 149 150 1035 106 141 132 151 134 152 1033 123 120 119 142 143 144 145 1035
106 153 154 155 156 157 158 159 142 143 144 143 160 152 1037 106 153 148 110 134 135 1035 123 161 162 154 155 156 157 1037
1032 1031 1032 109 110 111 163 164 165 127 166 167 168 152 1038 106 119 148 110 134 169 1037 123 170 171 108 126 110 111 1034
172 173 174 110 110 129 175 176 168 152 121 122 177 178 1033 106 119 148 110 149 153 179 180 177 181 128 110 110 129 1036
182 183 184 185 186 187 188 189 190 191 192 193 190 194 1035 182 183 184 185 195 191 196 194 190 194 184 185 186 187 1033
197 5 6 5 6 5 6 5 6 5 6 5 6 5 1037 197 5 6 5 6 5 6 5 6 5 6 5 6 5 1035
1034 1031 1032 1031 1032 1031 4099 4100 1032 1031 1032 1031 1032 1031 1034 1032 1031 4099 4100 1032 1031 1032 1031 1032 1031 1032 1032 1031 1032 1037
1036 1039 1040 1041 1042 1043 3073 3074 1039 1040 1034 1038 1039 1040 1036 1039 1040 3073 3074 1041 1042 1043 1039 1040 1041 1042 1043 1039 1040 1038
91 92 93 92 93 92 3073 3074 91 92 1036 94 93 92 93 92 93 3073 3074 91 92 93 92 93 1038 1044 1045 1046 1047 1048
95 102 198 96 199 200 3073 3074 95 102 201 202 203 204 205 206 207 3073 3074 95 102 208 209 210 1033 1049 1050 1051 1052 1051
182 183 211 212 213 214 3073 3074 182 183 215 216 217 218 219 220 190 3073 3074 182 183 211 212 190 1035 1048 1047 1053 1054 1048
197 5 6 5 221 5 3073 3074 197 5 6 5 6 5 6 5 6 3073 3074 197 5 6 5 6 1037 1051 1052 1055 1056 1051
1031 1032 1031 1032 1031 1032 1031 1032 1031 1032 1031 1032 4099 4100 1033 1032 1031 1032 1031 1032 1031 1032 1031 1032 1039 1040 1038 1057 1058 1059
91 92 93 92 93 92 93 92 93 92 93 92 3073 3074 1035 1041 1042 1043 1039 1040 1041 1042 1043 1039 1040 1038 1041 1042 1043 1060
95 102 103 104 101 102 101 102 97 98 99 100 3073 3074 1037 1044 1045 1061 1062 1063 1064 1059 1065 1066 1067 222 223 224 1068 1069
106 127 121 122 225 226 168 152 108 109 110 111 3073 3074 1038 1049 1050 1070 1071 1072 1073 1060 1074 1075 1076 227 228 229 1077 1078
106 230 231 232 156 155 233 230 128 110 110 129 3073 3074 1038 1079 1080 1053 1054 1048 1047 1081 1082 1069 1083 222 224 1079 1080 1053
106 230 108 126 234 110 134 164 142 143 144 145 3073 3074 1034 1084 1085 1055 1056 1051 1052 1086 1087 1078 1088 227 229 1084 1085 1055
106 119 128 235 110 110 236 119 168 152 237 238 3073 3074 1036 1048 1047 1057 1058 1044 1045 1053 1054 1048 1047 1089 1090 1053 1054 1057
106 230 142 143 144 143 160 135 114 137 118 135 3073 3074 1038 1051 1052 1039 1040 1049 1050 1055 1056 1051 1052 1091 1092 1055 1056 1093
182 183 211 212 239 107 240 241 132 151 149 169 3073 3074 1034 1061 1094 1047 1048 223 224 1057 1058 1093 1093 1048 1047 1057 1058 1095
197 5 6 5 120 119 242 243 244 245 246 153 3073 3074 1036 1070 1096 1052 1051 228 229 1039 1040 1095 1095 1051 1052 1048 1047 1097
1032 1031 1032 1031 1038 191 196 191 211 1038 1032 1031 1032 1031 1038 1048 1047 1098 1099 222 224 1059 1065 1066 1067 1069 1083 1051 1052 1100
1036 1038 1039 1040 1101 21509 21510 21509 21510 1102 1038 1039 1040 1039 1040 1051 1052 1103 1104 227 229 1060 1074 1075 1076 1078 1088 1069 1083 1048
1048 1105 1047 1048 1047 1041 1042 1043 1038 1041 1042 1043 1039 1040 1038 1106 1107 1108 1109 1110 1111 1112 1112 1113 1114 1105 1047 1078 1088 1051
