64 51
1054 1055 1056 1055 1056 1055 1056 1055 1056 1055 1056 1055 1056 1055 1054 1053 1056 1055 1057 1055 1056 1055 1056 1055 1057 1055 1056 1054 1056 1055 1056 1055 1056 1055 1056 1055 1056 1055 1056 1055 1056 1055 1057 1055 1056 1054 1056 1055 1056 1055 1056 1055 1056 1055 1056 1055 1056 1055 1056 1055 1056 1055 1056 1054
1058 119 120 121 120 121 120 121 120 121 120 121 120 121 1058 1059 119 120 121 120 121 120 121 120 121 120 121 1058 119 120 121 120 121 120 121 120 121 120 121 120 121 120 121 120 121 1058 122 121 120 121 120 121 120 121 120 121 120 121 120 123 124 121 120 1058
1047 125 126 127 126 127 126 127 126 127 126 127 126 127 1047 1054 125 128 129 130 131 132 133 134 135 136 129 1047 125 132 137 138 139 140 135 136 141 142 143 144 131 132 145 128 129 1047 146 127 126 127 126 127 126 127 126 127 126 127 126 147 148 127 126 1047
1050 149 150 151 152 153 154 155 156 157 156 158 159 160 1050 1058 161 162 163 164 165 166 167 168 169 170 171 1050 161 166 172 173 174 175 169 170 176 177 178 179 165 166 180 162 171 1050 181 157 156 151 152 182 183 184 154 184 154 155 185 186 187 157 156 1050
1050 149 188 189 190 2 2 191 150 192 193 158 159 194 1050 1047 195 196 197 196 197 196 197 196 197 196 197 1053 195 196 197 196 197 196 197 196 197 196 197 196 197 196 197 196 197 1053 181 198 150 189 190 2 2 2 2 2 2 191 199 186 187 192 193 1053
1054 149 159 200 2 2 2 201 202 203 204 205 206 157 1054 1050 1055 1056 1060 4112 4113 1055 1056 1055 1060 1055 1056 1059 1056 1055 1056 1055 1056 1055 1056 1055 4112 4113 1056 1055 1056 1055 1060 1055 1056 1059 181 207 208 200 209 2 2 2 2 2 2 191 210 186 187 211 212 1059
1058 149 156 200 2 2 2 191 185 213 185 214 215 216 1058 217 120 121 120 3086 3087 121 120 121 120 121 120 1053 218 121 120 121 120 121 120 121 3086 3087 120 121 120 121 120 121 120 1053 181 219 220 189 2 2 2 2 2 2 2 191 221 186 187 222 223 1054
1047 149 156 224 225 226 225 227 185 157 156 228 229 213 1047 230 231 232 130 3086 3087 233 231 232 130 145 128 1059 146 233 231 232 128 145 128 127 3086 3087 132 233 231 232 128 145 128 1059 181 211 212 200 2 2 2 2 2 2 2 191 234 186 187 157 156 1058
1050 149 199 235 199 157 156 151 236 184 154 155 156 192 1050 237 238 191 239 3086 3087 240 238 191 241 203 204 1050 181 242 238 191 243 203 204 235 3086 3087 244 245 238 191 243 203 204 1050 246 247 248 200 2 2 2 2 2 2 2 191 249 186 187 250 251 1047
1053 149 156 213 185 235 199 200 252 2 2 201 253 216 1053 237 2 191 185 3086 3087 200 2 191 204 254 255 1053 181 200 2 191 256 257 258 213 3086 3087 185 200 2 191 256 259 260 1050 181 192 241 189 2 2 2 2 2 2 2 191 221 186 187 261 262 1053
1059 149 156 157 156 235 199 200 252 2 2 201 156 213 1059 237 2 191 210 3086 3087 263 2 191 210 192 193 1059 181 200 2 191 193 264 265 213 3086 3087 265 200 2 191 193 264 265 266 267 268 269 200 2 2 2 2 2 2 2 191 234 186 187 157 156 1059
1054 149 199 270 271 157 156 200 252 2 2 201 253 192 272 273 2 191 239 3086 3087 263 2 191 241 274 269 266 267 242 2 191 243 275 276 235 3086 3087 244 245 2 191 243 277 206 264 221 278 279 200 2 2 2 2 2 2 2 191 208 186 187 280 281 1054
1058 161 282 283 284 171 285 286 287 288 287 289 164 180 162 286 287 289 166 3086 3087 286 287 289 162 172 173 171 164 286 287 289 164 167 168 171 3086 3087 166 286 287 289 164 169 170 165 166 171 164 286 287 288 287 288 287 288 287 289 175 186 187 172 173 1058
1047 195 196 197 196 197 196 197 196 197 196 197 196 197 196 197 196 197 196 3086 3087 197 196 197 196 197 196 197 196 197 196 197 196 197 196 197 3086 3087 196 197 196 197 196 197 196 197 196 197 196 197 196 197 196 197 196 197 196 197 196 186 187 197 196 1047
1053 1055 1056 1055 1056 1055 1056 1055 1056 1055 1056 1061 1055 1056 1055 1056 1055 1056 1055 1056 1061 1056 1055 1056 1055 1056 1055 1056 1055 1056 1055 1061 1055 1056 1055 1056 1055 1056 1055 1056 1055 1056 1055 1056 1055 1056 1055 1056 1055 1056 1055 1056 1055 1056 1055 1056 1055 1056 1054 290 187 1054 1055 1050
1059 1062 1063 1062 1063 1050 1064 1065 1066 1050 1050 19 1062 1063 1062 1063 1050 1064 1065 1066 20 1062 1063 1062 1063 1050 1064 1065 1066 1062 1063 20 1062 1063 1062 1063 1050 1064 1065 1066 1062 1063 1064 1065 1066 1050 1067 1068 1048 1049 1069 1070 1071 1072 1073 1074 1075 1076 1058 291 187 1058 1073 1074
1054 119 120 121 120 121 120 121 120 121 120 20 119 120 121 120 121 120 121 120 20 119 120 121 120 121 120 121 120 121 120 20 119 120 292 293 294 295 120 121 120 121 120 121 120 1054 1077 1078 1051 1052 1079 1080 1081 1082 1083 1084 21 22 23 291 187 1047 1083 1084
1058 125 128 133 134 141 142 135 136 296 297 19 125 128 135 136 296 297 141 142 19 125 128 135 136 133 134 131 132 135 136 19 125 132 298 299 300 301 302 303 231 232 126 127 126 1058 1062 1063 1085 1086 1067 1068 1087 1088 1089 1090 24 25 26 291 187 1050 1069 1070
1047 161 162 167 168 176 177 169 170 304 305 20 161 162 169 170 304 305 176 177 20 161 162 169 170 167 168 165 166 169 170 20 161 166 294 295 294 295 306 307 308 191 309 213 185 1047 1091 1092 1089 1090 1077 1078 1093 1094 1095 1096 27 28 29 291 187 1053 1079 1080
1050 195 196 197 196 197 196 197 196 197 196 19 195 196 197 196 197 196 197 196 19 195 196 197 196 197 196 197 196 197 196 19 195 196 300 301 300 301 310 2 2 311 312 157 156 1050 1097 1094 1095 1096 1050 1062 1063 1064 1065 1066 1085 1086 1059 291 187 1059 1098 1099
1073 1074 1053 1056 4112 4113 1055 1056 1055 1056 1055 1061 1055 1056 1055 1056 1055 1056 1055 1056 1061 1056 1055 1056 1055 1056 1055 1056 1055 1056 1055 1061 1055 1054 294 295 292 293 313 2 2 311 312 157 156 1050 1061 1056 1055 1056 1055 1056 1055 1056 1055 1057 1057 1056 1050 291 187 1054 1100 1052
1083 1084 1059 314 3086 3087 121 1054 1098 1099 1062 1063 1075 1076 1101 1102 1073 1074 1067 1067 1073 1074 1069 1070 1073 1074 1075 1076 1087 1088 1089 1090 1053 1058 300 301 298 299 315 2 2 201 199 213 185 121 20 119 120 121 120 121 120 121 120 121 120 121 120 316 187 1058 1085 1086
1103 1104 1054 149 3086 3087 127 1058 1100 1052 1105 1106 1045 1046 1107 1108 1083 1084 1077 1077 1083 1084 1079 1080 1083 1084 1045 1046 1093 1094 1095 1096 1059 1047 292 293 294 295 317 226 225 227 185 235 199 131 19 125 130 296 297 135 136 141 142 131 132 145 128 186 187 1047 1109 1110
1111 1112 1058 149 3086 3087 157 1047 1085 1086 1113 1114 1087 1088 1089 1090 1069 1070 1098 1099 1073 1074 1115 1116 1073 1074 1117 1118 1105 1106 1073 1119 1118 1050 298 299 300 301 318 235 199 157 156 213 185 165 20 161 164 304 305 169 170 176 177 165 166 180 162 186 187 1050 1120 1121
1073 1074 1047 149 3086 3087 160 1050 1069 1070 1103 1104 1093 1094 1095 1096 1079 1080 1100 1052 1083 1084 1122 1123 1083 1084 1124 1125 1113 1114 1083 1126 1125 1054 294 295 294 295 318 319 320 321 320 322 185 197 19 195 196 197 196 197 196 197 196 197 196 197 196 186 187 1053 1073 1074
1083 1084 1050 149 3086 3087 194 1053 1079 1080 1111 1112 1073 1074 1073 1074 1071 1072 1085 1086 1105 1106 1073 1074 1098 1099 1073 1074 1103 1104 1073 1127 1074 1058 300 301 300 301 318 200 323 324 2 311 210 1050 1061 4112 4113 1056 1055 1056 1055 1056 1055 1060 1060 1056 1050 290 187 1059 1083 1084
1071 1072 1053 149 3086 3087 325 1059 1109 1110 1062 1063 1083 1084 1083 1084 1081 1082 1062 1063 1113 1114 1083 1084 1100 1052 1083 1084 1111 1112 1083 1128 1084 1047 294 295 292 293 318 189 209 2 2 191 156 121 120 3086 3087 121 1050 1103 1104 1053 1069 1070 1129 1130 1053 291 187 1054 1075 1076
1081 1082 1059 149 3086 3087 213 1054 1120 1121 1101 1102 1109 1110 1071 1072 1115 1116 1091 1092 1089 1090 1073 1074 1085 1086 1071 1072 1115 1116 1053 1115 1116 1050 300 301 298 299 318 200 2 2 2 201 159 129 130 3086 3087 129 1053 1111 1112 1059 1079 1080 1131 1132 1059 291 187 1058 1045 1046
1062 1063 1054 149 3086 3087 157 1058 1062 1063 1107 1108 1120 1121 1081 1082 1122 1123 1097 1094 1095 1096 1083 1084 1062 1063 1081 1082 1122 1123 1059 1122 1123 1053 292 293 294 295 318 326 327 328 327 329 156 213 256 3086 3087 264 1059 1050 1062 1063 1109 1110 1062 1063 1054 291 187 1047 1129 1130
1053 330 1058 149 3086 3087 160 1047 1055 1056 1061 1056 1055 1056 1055 1056 1055 1056 1055 1056 1055 1053 1103 1104 1073 1074 1069 1070 1075 1076 1073 1119 1118 1059 298 299 300 301 318 158 159 331 332 235 199 157 156 3086 3087 333 1054 1129 1130 1050 1120 1121 1069 1070 1058 291 187 1053 1131 1132
1059 314 334 335 3086 3087 336 337 338 339 20 119 120 121 120 121 120 121 120 121 120 1059 1111 1112 1083 1084 1079 1080 1045 1046 1083 1126 1125 1054 294 295 294 295 340 171 282 341 342 171 282 171 282 3086 3087 180 1058 1131 1132 1073 1127 1074 1079 1080 1047 291 187 1059 1069 1070
1054 149 244 318 3086 3087 245 238 191 243 19 125 343 135 136 131 132 296 297 141 142 32798 32815 32816 1073 1074 1073 1074 1105 1106 1133 1074 1054 1058 300 301 300 301 344 197 196 197 196 197 196 197 196 3086 3087 197 1047 1069 1070 1083 1128 1084 1098 1099 1053 291 187 1054 1079 1080
1058 161 166 340 3086 3087 286 287 345 346 20 161 282 169 170 165 166 304 305 176 177 32802 32825 32826 1083 1084 1083 1084 1113 1114 1083 1084 1058 1047 1056 1055 1056 1055 1056 1055 1056 1055 1056 1055 1056 1055 1056 1055 1056 1055 1050 1079 1080 1073 1127 1074 1100 1052 1059 291 187 1058 1098 1099
1047 195 196 347 3086 3087 197 196 197 196 19 195 196 197 196 197 196 197 196 197 196 32791 32806 32807 1067 1067 1073 1074 1073 1074 1073 1074 1047 1103 1104 1062 1063 1071 1072 1105 1106 1075 1076 1073 1074 1098 1099 1129 1130 1073 1074 1115 1116 1083 1128 1084 1085 1086 1050 291 187 1047 1100 1052
1064 1056 1055 1056 1055 1056 1055 1056 1055 1056 1061 1056 1055 1056 1054 4112 4113 1050 1056 1055 1056 1064 1065 1066 1077 1077 1083 1084 1083 1084 1083 1084 1050 1111 1112 1073 1074 1081 1082 1113 1114 1045 1046 1083 1084 1100 1052 1131 1132 1083 1084 1122 1123 1067 1067 1073 1127 1074 1053 291 187 1050 1085 1086
1115 1116 1098 1099 1073 1074 1071 1072 1073 1074 1103 1104 1075 1076 1058 3086 3087 119 120 1053 1103 1104 1105 1106 1073 1074 1087 1088 1089 1090 1098 1099 1053 1134 1134 1083 1084 1098 1099 1073 1074 1098 1099 1062 1063 1085 1086 1073 1074 1062 1063 1073 1074 1077 1077 1083 1128 1084 1059 291 187 1053 1115 1116
1122 1123 1100 1052 1083 1084 1081 1082 1083 1084 1111 1112 1045 1046 1047 3086 3087 125 126 1059 1111 1112 1113 1114 1083 1084 1093 1094 1095 1096 1100 1052 1059 1115 1116 1129 1130 1100 1052 1083 1084 1100 1052 1071 1072 1115 1116 1135 1136 1098 1099 1083 1084 1109 1110 1073 1069 1070 1054 291 187 1059 1122 1123
1069 1070 1085 1086 1067 1068 1129 1130 1073 1074 1091 1092 1089 1090 1050 3086 3087 149 159 1054 1073 1074 1115 1116 1073 1074 1098 1099 1109 1110 1085 1086 1054 1122 1123 1131 1132 1085 1086 1062 1063 1085 1086 1081 1082 1122 1123 1083 1084 1100 1052 1071 1072 1120 1121 1083 1079 1080 1058 291 187 1054 1073 1074
1079 1080 1062 1063 1077 1078 1131 1132 1083 1084 1097 1094 1095 1096 1053 3086 3087 149 265 1058 1083 1084 1122 1123 1083 1084 1100 1052 1120 1121 1133 1074 1058 1073 1074 1053 1050 1055 1056 1055 1056 1055 1056 1050 1054 1103 1104 1129 1130 1085 1086 1081 1082 1050 1087 1088 1089 1090 1047 291 187 1058 1083 1084
1054 1056 1055 1056 1055 1056 1053 1055 1061 1056 1055 1056 1055 1056 1059 3086 3087 149 348 1047 1055 1054 1133 1074 1098 1099 1085 1086 1073 1074 1083 1084 1047 1083 1084 1059 218 121 120 121 120 121 120 121 1058 1111 1112 1131 1132 1064 1065 1066 1062 1063 1093 1094 1095 1096 1053 291 187 1047 1071 1072
1058 119 120 121 120 349 1059 350 19 119 120 121 120 121 120 3086 3087 149 351 321 352 1058 1083 1084 1100 1052 1062 1063 1083 1084 1062 1063 1056 1055 1056 1057 353 303 231 303 231 303 231 232 1047 1056 1061 1056 1055 1056 1055 1056 1057 1056 1055 1056 1055 1056 1059 291 187 1053 1081 1082
1047 125 128 296 297 131 132 354 19 125 130 135 136 141 142 3086 3087 149 355 356 357 1047 1073 1074 1085 1086 1115 1116 1071 1072 1053 119 120 121 120 121 355 356 2 2 2 2 2 311 120 121 20 119 120 121 120 121 120 121 120 121 120 121 120 316 187 1059 1098 1099
1050 161 162 304 305 165 166 180 20 161 164 169 170 176 177 3086 3087 161 358 288 359 1050 1083 1084 1062 1063 1122 1123 1081 1082 1059 125 130 131 132 145 360 328 327 328 327 328 327 329 128 131 19 125 132 296 297 131 132 131 132 361 362 141 142 186 187 1054 1100 1052
1054 195 196 197 196 197 196 197 19 195 196 197 196 197 196 3086 3087 195 196 197 196 1054 1071 1072 1073 1074 1073 1074 1098 1099 1054 161 164 363 166 180 162 165 166 3 4 165 364 180 162 165 20 161 166 365 366 363 166 165 166 367 368 176 173 186 187 1058 1085 1086
1058 1055 1056 4112 4113 1055 1056 1055 1061 1055 1056 1055 1056 1055 1053 1055 1056 1055 1056 1055 1056 1058 1081 1082 1083 1084 1083 1084 1100 1052 1058 195 196 197 196 197 196 197 196 5 6 197 196 197 196 197 19 195 196 197 196 197 196 197 196 197 196 197 196 186 187 1047 1073 1074
1047 119 120 3086 3087 119 120 121 19 119 120 121 120 121 1059 369 120 121 120 121 120 1047 1069 1070 1103 1104 1073 1074 1085 1086 1047 1050 1056 1055 1056 1060 1055 1056 1055 1056 1055 1056 1055 1056 1055 1056 1061 1056 1055 1056 1055 1056 1060 1056 1055 1056 1055 1056 1137 290 187 1050 1083 1084
1050 125 132 3086 3087 125 130 131 19 125 132 133 134 145 128 370 371 129 130 372 373 1050 1079 1080 1111 1112 1083 1084 1050 1062 1063 1062 1063 1062 1063 1064 1065 1066 1073 1074 1073 1074 1073 1074 1073 1074 1098 1099 1138 1139 1073 1074 1073 1074 1087 1088 1089 1090 1050 291 187 1050 1109 1110
1053 161 166 3086 3087 161 164 165 20 161 166 167 168 180 162 374 305 171 164 171 282 1053 1109 1110 1073 1074 1109 1110 1073 1074 1129 1130 1073 1074 1098 1099 1073 1074 1083 1084 1083 1084 1083 1084 1083 1084 1100 1052 1079 1140 1083 1084 1083 1084 1093 1094 1095 1096 1141 21522 21522 1142 1120 1121
1059 195 196 3086 3087 195 196 197 19 195 196 197 196 197 196 197 196 197 196 197 196 1059 1120 1121 1083 1084 1120 1121 1083 1084 1131 1132 1083 1084 1100 1052 1083 1084 1073 1074 1087 1088 1089 1090 1073 1074 1085 1086 1091 1092 1089 1090 1073 1074 1103 1104 1073 1074 1075 1076 1098 1099 1098 1099
1053 1055 1056 1055 1056 1055 1056 1055 1061 1055 1056 1055 1056 1055 1056 1055 1056 1055 1056 1055 1056 1053 1067 1068 1073 1074 1067 1068 1073 1074 1073 1074 1115 1116 1085 1086 1103 1104 1083 1084 1093 1094 1095 1096 1083 1084 1067 1068 1097 1094 1095 1096 1083 1084 1111 1112 1083 1084 1045 1046 1100 1052 1100 1052
1059 1062 1063 1064 1065 1066 1062 1063 1062 1063 1062 1063 1050 1050 1062 1063 1062 1063 1064 1065 1066 1059 1077 1078 1083 1084 1077 1078 1083 1084 1083 1084 1122 1123 1062 1063 1111 1112 1073 1074 1069 1070 1073 1074 1073 1074 1077 1078 1109 1110 1071 1072 1073 1074 1073 1074 1073 1074 1073 1074 1085 1086 1085 1086
