51 50
1081 1082 1083 1084 1085 1081 1082 1083 1072 1081 1082 1083 1072 1053 1086 1054 1053 1054 1048 1049 1064 1065 1055 1056 1053 1054 1087 1088 1053 1054 1053 1086 1054 1062 1063 1064 1065 1053 1086 1054 1062 1063 1048 1089 1049 1048 1089 1049 1048 1089 1049
1072 1072 1090 1091 1090 1091 1090 1091 1090 1091 1090 1091 1072 1048 1089 1049 1048 1049 1073 1052 1070 1071 1059 1046 1048 1049 1092 1093 1048 1049 1048 1089 1049 1068 1069 1070 1071 1048 1089 1049 1068 1069 1094 1067 1078 1079 1080 1095 1053 1086 1054
1057 1096 119 120 121 120 121 122 123 120 121 120 1057 1097 1087 1088 1053 1054 1074 1058 1097 1098 1053 1054 1053 1054 1073 1052 1064 1065 1094 1067 1075 1099 1055 1056 1053 1054 1100 1099 1053 1054 1101 1102 1103 1104 1105 1106 1048 1089 1049
1060 1051 124 125 126 127 128 129 130 127 128 131 1060 1047 1092 1093 1048 1049 1076 1061 1047 1107 1048 1049 1048 1049 1074 1058 1070 1071 1101 1102 1077 1108 1059 1046 1048 1049 1109 1108 1048 1049 1064 1065 1110 1111 1053 1054 1055 1056 1096
1066 1057 132 133 134 135 136 137 138 135 139 140 1066 1055 1056 1097 1053 1054 1080 1096 1090 1091 1090 1091 1090 1091 1090 1091 1090 1091 1072 1091 1090 1091 1090 1091 1090 1091 1090 1057 1053 1054 1070 1071 1112 1113 1048 1049 1059 1046 1051
1096 1060 141 142 143 20 143 137 138 20 143 20 1072 1059 22 23 24 25 26 27 119 120 121 120 121 120 121 120 121 120 1114 120 121 120 121 120 121 120 121 1060 1048 1049 1081 1082 1083 1087 1088 1053 1054 1094 1067
1051 1066 1090 1091 1090 1091 1115 144 138 1115 1091 1090 1096 1073 28 29 30 31 32 33 145 146 147 148 147 148 147 149 150 151 152 146 147 148 147 148 147 149 150 1066 1090 1091 1090 1091 1096 1092 1093 1048 1049 1101 1102
1062 1063 1073 1052 1053 1054 1072 153 138 1057 1073 1052 1051 1074 34 24 25 35 22 36 154 155 156 2 2 2 2 157 158 159 160 161 156 2 2 2 2 157 162 163 164 165 1116 1117 1051 1094 1067 1110 1111 1053 1054
1068 1069 1074 1058 1048 1049 1057 153 138 1060 1074 1058 1057 1076 37 38 39 40 41 42 166 167 168 169 170 169 170 171 172 173 174 175 170 169 170 169 170 171 136 176 177 140 172 140 1057 1101 1102 1112 1113 1048 1049
1053 1054 1076 1061 1062 1063 1060 153 138 1066 1076 1061 1060 1094 43 44 45 46 47 48 166 178 179 20 143 20 143 20 143 20 143 20 143 20 143 20 143 20 143 20 143 20 143 20 1060 1053 1086 1054 1053 1086 1054
1048 1049 1055 1056 1068 1069 1066 153 138 1072 1100 1099 1066 1101 1102 1055 1056 1053 1054 1096 154 180 4112 4113 1096 1090 1091 1090 1091 1090 1118 1090 1091 1090 1091 1090 1091 1090 1091 1090 1091 1090 1119 1120 1066 1048 1089 1049 1048 1089 1049
1062 1063 1059 1046 1081 1082 1083 153 138 1057 1109 1108 1081 1082 1083 1059 1046 1048 1049 1051 181 178 3086 3087 1051 1073 1052 1084 1085 1064 1065 1062 1063 1078 1079 1080 1095 1121 1122 1064 1065 1100 1099 1053 1054 1087 1088 1064 1065 1100 1099
1068 1069 1121 1122 1055 1056 1072 153 138 1060 1053 1054 1121 1122 1097 1098 1064 1065 1096 1057 182 183 3086 3087 1057 1074 1058 1055 1056 1070 1071 1068 1069 1103 1104 1105 1106 1123 1124 1070 1071 1109 1108 1048 1049 1092 1093 1070 1071 1109 1108
1084 1085 1123 1124 1059 1046 1096 153 138 1066 1048 1049 1123 1124 1047 1107 1070 1071 1051 1060 184 180 3086 3087 1060 1076 1061 1059 1046 1072 1057 1053 1054 1100 1099 1073 1052 1053 1054 1053 1054 1053 1054 1073 1052 1053 1054 1053 1054 1121 1122
1053 1054 1087 1088 1072 1090 1051 153 138 1072 1090 1091 1090 1091 1090 1091 1072 1091 1090 1066 185 183 3086 3087 1066 1090 1096 1053 1086 1054 1060 1125 1126 1109 1108 1074 1058 1125 1126 1048 1049 1125 1126 1074 1058 1048 1049 1048 1049 1123 1124
1048 1049 1092 1093 1096 186 121 187 138 120 121 120 121 120 121 188 32886 120 121 120 154 180 3086 3087 120 121 32795 32792 32833 1049 1066 1048 1049 1053 1054 1076 1061 1048 1049 1053 1054 1048 1049 1076 1061 1084 1085 1100 1099 1053 1054
1084 1085 1127 1128 1051 189 128 137 138 190 191 127 128 192 193 194 32886 131 195 127 196 197 3086 3087 127 128 32801 32797 32830 1054 1100 1099 1096 1125 1126 1096 1053 1086 1054 1048 1049 1053 1086 1054 1096 1097 1097 1109 1108 1048 1049
1073 1052 1129 1130 1057 198 136 137 138 199 200 135 136 201 202 203 32886 140 204 135 136 135 3086 3087 135 139 32804 32792 32833 1049 1109 1108 1051 1048 1049 1051 1048 1089 1049 1073 1052 1048 1089 1049 1051 1047 1047 1084 1085 1053 1054
1074 1058 1064 1065 1060 205 143 144 138 142 143 20 143 20 143 206 32886 20 143 20 143 20 3086 3087 20 143 32810 32865 32866 1078 1079 1080 1095 1053 1086 1054 1053 1086 1054 1074 1058 1053 1086 1054 1064 1065 1055 1056 1096 1048 1049
1076 1061 1070 1071 1066 1090 1072 153 138 1072 1090 1091 1090 1091 1090 1091 1072 1091 1090 1091 1090 1091 1090 1091 1090 1091 1072 1123 1124 1103 1104 1105 1106 1048 1089 1049 1048 1089 1049 1076 1061 1048 1089 1049 1070 1071 1059 1046 1051 1084 1085
1081 1082 1083 1081 1082 1083 1072 21525 21525 1072 1084 1085 1081 1082 1083 1081 1082 1083 1084 1085 1084 1085 1081 1082 1083 1081 1082 1083 1084 1085 1084 1085 1081 1082 1083 1081 1082 1083 1081 1082 1083 1081 1082 1083 1081 1082 1083 1084 1085 1057 1053
1057 1090 1091 1090 1091 1096 1091 1090 1091 1090 1091 1072 1091 1090 1091 1090 1091 1090 1091 1090 1091 1090 1114 1090 1091 1090 1091 1090 1091 1090 1091 1090 1091 1096 1091 1090 1091 1090 1091 1090 1091 1090 1091 1090 1091 1090 1091 1090 1091 1057 1053
1060 186 121 122 123 1051 119 120 121 120 121 32886 188 120 121 120 121 120 121 120 121 120 121 120 121 120 121 120 121 120 121 120 121 1051 119 120 121 120 121 120 121 120 121 120 121 120 121 120 121 1060 1048
1066 189 128 129 130 207 208 190 191 209 210 32886 194 127 128 192 193 131 195 131 195 190 191 125 126 209 210 131 195 127 128 190 191 207 208 125 126 131 195 209 210 165 150 165 211 148 147 149 150 1066 1053
1072 198 136 137 138 212 213 199 200 214 215 32886 203 135 136 201 202 140 204 140 204 199 200 133 134 214 215 140 216 135 136 199 200 212 213 133 134 140 204 214 215 140 217 178 218 219 220 221 179 1072 1048
1096 205 143 137 138 20 143 142 143 20 143 32886 206 20 143 20 143 20 143 20 143 142 143 20 143 20 143 20 143 20 143 142 143 20 143 20 143 20 143 20 143 20 143 178 222 2 2 223 179 1096 1053
1051 1090 1057 144 138 1096 1090 1091 1090 1091 1090 1072 1090 1091 1090 1091 1090 1091 1090 1091 1090 1091 1118 1091 1090 1091 1090 1091 1090 1091 1090 1091 1090 1072 1090 1091 1090 1091 1090 1091 1090 1091 1057 224 225 226 227 228 179 1051 1048
1127 1128 1060 153 138 1051 1053 1086 1054 1094 1067 1110 1111 1064 1065 1062 1063 1127 1128 1053 1086 1054 1064 1065 1053 1054 1064 1065 1053 1054 1053 1054 1064 1065 1121 1122 1096 1097 1097 1053 1086 1054 1060 229 179 230 231 232 179 1057 1053
1129 1130 1066 153 138 1057 1048 1089 1049 1101 1102 1112 1113 1070 1071 1068 1069 1129 1130 1048 1089 1049 1070 1071 1048 1049 1070 1071 1048 1049 1048 1049 1070 1071 1123 1124 1051 1047 1047 1048 1089 1049 1066 229 233 161 156 157 179 1060 1048
1075 1099 1072 153 138 1060 1067 1075 1099 1084 1085 1053 1054 1073 1052 1053 1054 1094 1067 1110 1111 1053 1054 1055 1056 1131 1053 1054 1064 1065 1053 1086 1054 1053 1086 1054 1064 1065 1078 1079 1080 1095 1096 229 179 161 2 157 179 1066 1053
1077 1108 1096 153 138 1066 1102 1077 1108 1064 1065 1125 1126 1074 1058 1048 1049 1101 1102 1112 1113 1048 1049 1059 1046 1057 1048 1049 1070 1071 1048 1089 1049 1048 1089 1049 1070 1071 1103 1104 1105 1106 1051 229 234 235 168 171 172 1096 1048
1087 1088 1051 153 138 1072 1097 1053 1054 1070 1071 1048 1049 1076 1061 1084 1085 1081 1082 1083 1081 1082 1083 1084 1085 1060 1087 1088 1053 1054 1064 1065 1073 1052 1132 1133 1100 1099 1084 1085 1084 1085 1057 229 236 232 179 20 143 1051 1053
1092 1093 1057 153 138 1057 1047 1048 1049 1057 1090 1091 1090 1091 1090 1091 1090 1091 1090 1091 1090 1091 1090 1091 1090 1066 1092 1093 1048 1049 1070 1071 1074 1058 1134 1135 1109 1108 1057 186 121 120 121 229 237 238 239 1084 1085 1057 1048
1053 1054 1060 153 138 1060 1053 1054 1110 1060 119 120 121 120 121 120 121 120 121 120 121 120 121 120 121 1057 1053 1054 1053 1054 1100 1099 1076 1061 1097 1098 1053 1054 1060 189 210 165 150 178 222 157 179 1116 1117 1060 1053
1048 1049 1066 153 138 1066 1048 1049 1112 1066 124 127 128 165 150 151 152 209 210 165 150 240 241 165 150 36 49 28 24 1049 1109 1108 1084 1085 1047 1107 1048 1049 1066 198 215 140 217 140 242 171 172 243 244 1066 1048
1055 1056 1072 153 138 1072 1055 1056 1096 1057 245 246 247 248 233 159 160 249 250 178 179 251 252 178 179 42 50 34 51 1099 1053 1054 1053 1054 1062 1063 1136 1137 1072 205 143 20 143 20 143 20 143 20 143 1072 1053
35 22 48 153 138 1096 1059 1046 1051 1060 1091 1090 1091 253 179 254 255 1091 1090 1091 256 257 258 197 162 33 52 37 53 1108 1048 1049 1048 1049 1068 1069 1138 1139 1140 1090 1091 1090 1091 1090 1091 1090 1140 1119 1120 1096 1048
49 28 33 153 138 1051 1073 1052 1072 1066 259 260 261 262 179 248 233 263 264 260 265 266 267 268 269 36 54 55 56 1095 1132 1133 1100 1099 1072 1141 1057 1090 1091 1090 1091 1090 1091 1090 1091 1072 1091 1090 1091 1051 1072
50 34 36 153 138 1057 1074 1058 1097 1057 154 178 179 183 158 178 179 270 267 248 233 201 202 246 247 1066 1103 1104 1105 1106 1134 1135 1109 1108 1073 1052 1060 186 121 120 121 120 121 120 121 120 121 120 121 1057 1053
52 37 42 153 138 1060 1076 1061 1047 1060 154 197 162 1091 1090 1091 256 271 272 178 1091 1090 1091 273 162 1072 1053 1054 1053 1054 1121 1122 1053 1054 1074 1058 1066 274 275 131 195 276 277 240 241 190 191 209 210 1060 1048
1062 1063 1072 153 138 1066 1127 1128 1072 1066 154 246 247 263 264 260 265 278 279 178 280 260 261 281 282 1096 1048 1049 1048 1049 1123 1124 1048 1049 1076 1061 1072 283 284 140 204 19 285 212 213 199 200 214 215 1066 1053
1068 1069 1096 153 138 1096 1129 1130 1072 1096 154 286 287 288 289 248 233 183 158 178 179 290 287 288 252 1051 1057 1081 1082 1083 1072 1096 1081 1082 1083 1072 1096 205 143 20 143 20 143 20 143 142 143 20 143 1096 1048
1121 1122 1051 153 138 1051 1090 1096 1090 1051 154 291 292 157 293 178 1090 1091 1090 1091 256 294 292 157 295 1072 1060 1091 1090 1091 1090 1051 1090 1091 1090 1091 1051 1090 1091 1090 1091 1090 1091 1090 1091 1072 4112 4113 1072 1051 1053
1123 1124 1057 153 138 120 121 1051 119 120 154 235 168 296 267 178 1081 1082 1083 1072 154 161 2 157 234 297 1066 298 121 120 121 120 121 120 121 120 121 120 121 120 121 120 121 120 121 188 3086 3087 120 1057 1048
1100 1099 1060 153 138 209 210 297 299 127 196 178 179 300 301 178 280 260 261 260 265 161 2 223 179 178 280 302 195 190 191 12306 303 131 195 240 241 190 191 209 210 125 126 276 277 194 3086 3087 165 1060 1053
1109 1108 1066 153 138 214 215 140 172 135 136 140 172 176 177 304 305 140 172 306 307 175 170 171 172 304 305 140 204 199 200 12307 285 140 204 212 213 199 200 214 215 133 134 19 285 203 3086 3087 140 1066 1048
1064 1065 1096 153 138 20 143 20 143 20 143 20 143 20 143 20 143 20 143 20 143 20 143 20 143 20 143 20 143 142 143 12308 143 20 143 20 143 142 143 20 143 20 143 20 143 206 3086 3087 20 1096 1053
1070 1071 1051 153 138 1072 1091 1072 1091 1090 1091 1090 1091 1090 1091 1090 1091 1090 1091 1090 1091 1090 1091 1090 1091 1090 1072 1090 1091 1090 1091 1072 1091 1090 1091 1090 1091 1090 1091 1090 1091 1090 1091 1090 1091 1090 1091 1090 1091 1051 1048
1053 1054 1051 21525 21525 1072 1072 1053 1054 1053 1054 1053 1054 1053 1054 1053 1054 1053 1054 1053 1054 1053 1054 1053 1054 1053 1054 1053 1054 1053 1054 1053 1054 1053 1054 1053 1054 1053 1054 1053 1054 1053 1054 1053 1054 1053 1054 1053 1054 1053 1054
1048 1049 1084 1085 1081 1082 1083 1048 1049 1048 1049 1048 1049 1048 1049 1048 1049 1048 1049 1048 1049 1048 1049 1048 1049 1048 1049 1048 1049 1048 1049 1048 1049 1048 1049 1048 1049 1048 1049 1048 1049 1048 1049 1048 1049 1048 1049 1048 1049 1048 1049
