80 40
1064 1097 1098 1097 1098 1097 1098 1097 1098 1097 1098 1097 1098 1097 1098 1067 1097 1098 1097 1098 1097 1098 1097 1098 1064 1058 1067 1058 1097 1098 1097 1098 1097 1098 1097 1098 1097 1098 1097 1098 1097 1098 1097 1098 1097 1098 1097 1098 1097 1098 1097 1098 1097 1098 1097 1098 1097 1098 1097 1098 1097 1098 1097 1098 1097 1098 1097 1098 1097 1098 1097 1098 1097 1098 1067 1068 1097 1098 1097 1098
1065 145 146 147 146 147 148 149 150 151 145 146 147 146 147 1099 21524 21524 21524 21524 21524 21524 21524 21524 1100 152 153 1099 21524 21524 21524 21524 21524 21524 21524 21524 21524 21524 21524 21524 21524 21524 21524 21524 21524 21524 21524 21524 21524 21524 21524 21524 21524 21524 21524 21524 21524 21524 21524 21524 21524 21524 21524 21524 21524 21524 21524 21524 21524 1100 147 146 147 146 1058 1055 145 146 147 146
1072 152 154 155 154 155 156 157 158 159 152 160 153 160 153 26 161 162 153 160 153 160 161 162 1067 163 24 1067 161 162 153 160 153 160 153 160 153 160 153 160 153 160 161 162 153 160 153 160 153 160 153 160 153 160 164 161 162 164 153 160 153 160 153 160 153 160 153 160 161 162 153 160 155 154 1061 1058 152 160 153 160
1055 165 166 167 168 169 156 157 158 159 165 166 167 170 24 27 171 172 173 174 175 176 171 172 1067 163 175 1067 171 172 177 178 179 170 180 181 24 182 24 182 24 182 171 172 183 184 24 182 185 178 179 186 187 188 189 171 172 189 24 182 190 191 24 182 192 193 24 182 171 172 194 195 196 197 1055 1061 163 182 24 182
1058 198 199 2 200 192 156 157 158 159 198 199 2 201 24 28 161 162 202 203 2 204 161 162 1067 203 2 1067 161 162 205 2 2 201 24 182 194 195 24 182 24 182 161 162 169 206 187 188 207 2 2 201 24 208 189 161 162 189 177 178 179 209 177 178 179 170 24 182 161 162 183 184 210 211 1058 1055 163 182 24 182
1061 212 213 214 215 187 156 157 158 159 212 213 214 215 24 28 171 172 216 213 214 215 171 172 217 213 214 218 171 172 219 220 221 222 24 182 177 178 179 170 180 181 171 172 24 182 24 208 223 224 221 225 190 191 189 171 172 189 226 2 2 201 205 2 2 201 24 182 171 172 227 228 24 182 1061 1055 229 230 231 232
1064 163 188 1101 1102 187 156 157 158 159 163 182 233 234 235 28 161 162 24 182 183 184 161 162 24 182 183 184 161 162 24 182 24 182 194 195 236 2 2 237 24 182 161 162 194 195 24 182 169 206 24 182 210 211 189 161 162 189 219 220 221 225 219 220 221 225 180 181 161 162 187 188 238 239 240 241 242 243 243 244
1065 245 246 247 248 247 156 157 158 159 245 248 249 250 247 27 251 252 247 248 253 254 251 252 247 248 253 254 251 252 247 248 247 248 247 248 255 256 257 258 247 248 251 252 247 248 247 248 247 248 247 248 247 248 259 251 252 259 247 248 247 248 247 248 247 248 247 248 251 252 247 246 247 248 247 260 261 262 263 264
1072 265 266 267 266 267 268 269 270 271 272 266 267 266 267 28 273 274 267 266 267 266 273 274 267 266 267 266 273 274 267 266 267 266 267 266 267 266 267 266 267 266 273 274 267 266 267 266 267 266 267 266 267 266 275 273 274 275 267 266 267 266 267 266 267 266 267 266 273 274 267 266 267 266 267 266 276 277 278 279
1055 1097 1098 1103 1104 1097 1098 1097 1098 1097 1098 1097 1098 1097 1098 1050 1097 1098 1097 1098 1097 1098 1097 1098 1097 1098 1097 1098 1097 1098 1097 1098 1097 1098 1097 1098 1097 1098 1097 1098 1097 1098 1097 1098 1097 1098 1097 1098 1097 1098 1097 1098 1097 1098 1097 1098 1097 1098 1097 1098 1097 1098 1097 1098 1097 1098 1097 1098 1097 1098 1097 1098 1097 1098 1097 1098 1097 1098 1097 1098
1105 1106 1067 1068 1089 1090 1073 1074 1075 1073 1075 1073 1075 1073 1075 1107 1108 1089 1090 1073 1074 1075 1078 1079 1080 1081 1073 1075 1107 1108 1089 1090 1105 1106 1067 1068 1093 1094 1073 1074 1075 1078 1079 1080 1081 1105 1106 1067 1073 1075 1067 1068 1089 1090 1073 1074 1075 1078 1079 1080 1081 1068 1109 1110 1111 1064 1067 1068 1089 1090 1073 1074 1075 1107 1108 1093 1094 1112 1113 1067
1114 1115 1107 1108 1116 1117 1071 1082 1066 1071 1066 1071 1066 1071 1066 1069 1070 1116 1117 1071 1082 1066 1085 1086 1087 1088 1071 1066 1069 1070 1116 1117 1114 1115 1107 1108 1118 1119 1071 1082 1066 1085 1086 1087 1088 1114 1115 1107 1071 1066 1107 1108 1116 1117 1071 1082 1066 1085 1086 1087 1088 1064 1120 1121 1122 1065 1107 1108 1116 1117 1071 1082 1066 1069 1070 1118 1119 1123 1124 1055
1125 1126 1069 1070 1127 1128 1073 1074 1075 1112 1113 1095 1096 1073 1074 1075 1073 1074 1075 1073 1074 1075 1073 1075 1095 1096 1073 1074 1075 1089 1090 1073 1074 1075 1069 1070 1127 1128 1073 1074 1075 1112 1113 1095 1096 1125 1126 1069 1125 1126 1069 1070 1127 1128 1073 1074 1075 1112 1113 1095 1096 1065 1129 1130 1131 1072 1069 1070 1127 1128 1073 1074 1075 1112 1113 1095 1096 1093 1094 1058
1132 1133 1067 1068 1134 1135 1071 1082 1066 1123 1124 1136 1137 1071 1082 1066 1071 1082 1066 1071 1082 1066 1071 1066 1136 1137 1071 1082 1066 1116 1117 1071 1082 1066 1067 1068 1134 1135 1071 1082 1066 1123 1124 1136 1137 1132 1133 1067 1132 1133 1067 1068 1134 1135 1071 1082 1066 1123 1124 1136 1137 1072 1138 29 30 31 1067 1068 1134 1135 1071 1082 1066 1123 1124 1136 1137 1118 1119 1055
1073 1074 1075 1078 1079 1080 1081 1073 1075 1107 1108 1089 1090 1064 1108 1112 1113 1125 1126 1093 1094 1139 1140 1127 1128 1081 1073 1075 1107 1108 1093 1094 1073 1074 1075 1078 1079 1080 1081 1073 1075 1107 1108 1093 1094 1073 1074 1075 1073 1074 1075 1078 1079 1080 1081 1073 1075 1107 1108 1093 1094 1055 1141 32 33 34 1107 1108 1093 1094 1112 1113 1055 1107 1108 1093 1094 1112 1113 1058
1071 1082 1066 1085 1086 1087 1088 1071 1066 1069 1070 1116 1117 1065 1070 1123 1124 1132 1133 1118 1119 1067 1068 1134 1135 1088 1071 1066 1069 1070 1118 1119 1071 1082 1066 1085 1086 1087 1088 1071 1066 1069 1070 1118 1119 1071 1082 1066 1071 1082 1066 1085 1086 1087 1088 1071 1066 1069 1070 1118 1119 1058 1142 35 36 37 1069 1070 1118 1119 1123 1124 1064 1069 1070 1118 1119 1123 1124 1061
1073 1074 1075 1112 1113 1095 1096 1073 1074 1075 1073 1074 1075 1072 1094 1139 1140 1127 1128 1073 1075 1139 1140 1127 1128 1096 1073 1074 1075 1073 1074 1075 1073 1074 1075 1112 1113 1095 1096 1073 1074 1075 1073 1074 1075 1073 1074 1075 1073 1074 1075 1112 1113 1095 1096 1073 1074 1075 1073 1074 1075 1061 1143 38 39 40 1112 1113 1095 1096 1093 1094 1065 1112 1113 1095 1096 1093 1094 1055
1071 1082 1066 1123 1124 1136 1137 1071 1082 1066 1071 1082 1066 1055 1119 1067 1068 1134 1135 1071 1066 1067 1068 1134 1135 1137 1071 1082 1066 1071 1082 1066 1071 1082 1066 1123 1124 1136 1137 1071 1082 1066 1071 1082 1066 1071 1082 1066 1071 1082 1066 1123 1124 1136 1137 1071 1082 1066 1071 1082 1066 1064 1144 1145 1146 1065 1123 1124 1136 1137 1118 1119 1072 1123 1124 1136 1137 1118 1119 1055
1105 1106 1067 1068 1089 1090 1073 1074 1075 1078 1079 1080 1081 1073 1075 1107 1108 1089 1090 1064 1147 1148 1149 1067 1068 1067 1068 1055 1055 1147 1148 1149 1067 1068 1147 1148 1149 1067 1068 1067 1068 1055 1055 1147 1148 1149 1067 1068 1147 1148 1149 1067 1068 1067 1068 1055 1055 1147 1148 1149 1067 1068 1109 1110 1111 1064 1067 1068 1067 1068 1055 1055 1147 1148 1149 1067 1068 1067 1068 1067
1114 1115 1107 1108 1116 1117 1071 1082 1066 1085 1086 1087 1088 1071 1066 1069 1070 1116 1117 1065 145 146 147 146 147 146 147 146 147 146 147 146 147 146 147 146 147 146 147 146 147 146 147 146 147 146 147 146 147 146 147 146 147 146 147 146 280 281 282 147 146 1064 1120 1121 1122 1065 145 146 147 146 147 146 147 1067 1068 283 147 146 147 146
1125 1126 1069 1070 1127 1128 1073 1074 1075 1112 1113 1095 1096 1073 1074 1075 1073 1074 1075 1072 152 160 153 160 153 160 284 285 153 160 286 287 153 160 286 287 153 160 288 289 290 291 290 291 153 160 153 160 292 293 294 295 153 160 153 160 164 296 297 153 160 1065 1129 1130 1131 1072 152 160 153 160 290 291 286 1058 1055 298 153 160 155 154
1132 1133 1067 1068 1134 1135 1071 1082 1066 1123 1124 1136 1137 1071 1082 1066 1071 1082 1066 1055 163 181 190 191 180 181 299 300 175 174 301 211 302 303 210 211 187 188 227 228 183 304 190 305 24 182 180 181 306 307 2 308 238 239 190 191 189 22 23 227 228 1072 1138 29 30 31 163 182 194 195 24 208 210 1061 1058 21 194 195 196 197
1064 1098 1097 1098 1097 1098 1097 1098 1097 1098 1097 1098 1097 1064 1108 1112 1113 1125 1126 1058 245 248 309 310 247 248 306 311 312 2 313 182 314 315 247 248 247 246 316 317 253 254 309 310 247 248 24 182 318 2 2 319 247 248 309 310 320 22 23 316 317 1055 1141 32 33 34 163 191 177 178 179 170 180 1055 1061 21 183 184 210 211
1065 145 146 147 146 147 146 147 146 147 146 147 146 1065 1070 1123 1124 1132 1133 1061 272 266 267 266 267 266 318 321 2 2 313 195 267 266 267 266 267 266 322 266 267 266 267 266 267 266 180 181 219 220 221 323 267 266 267 266 267 22 23 267 266 1058 1142 35 36 37 163 211 236 2 2 201 183 1058 1055 21 169 206 180 181
1072 152 160 153 160 155 154 153 324 325 160 153 160 1072 1094 1139 1140 1127 1128 1064 1097 4114 4115 1098 1097 1098 326 2 2 2 313 1058 1098 1097 1098 1097 1098 1097 1098 1097 1098 4114 4115 1098 1097 1098 1055 189 327 328 189 4114 4115 1098 1097 1098 1097 329 23 1098 1097 1061 1143 38 39 40 163 182 219 220 221 225 194 1061 1055 21 180 181 330 331
1055 163 332 194 195 169 206 24 333 334 181 194 195 1055 1119 1067 1068 1134 1135 1065 335 3086 3087 147 146 1064 326 2 2 2 336 1061 1055 1147 1148 1149 1067 1068 1147 1148 1055 3086 3087 1055 1050 1067 1068 189 337 338 189 3086 3087 1064 1147 1148 1149 339 23 1067 1068 1064 1144 1145 1146 1065 163 182 187 188 238 239 187 340 341 342 183 184 1101 1102
1058 163 343 344 345 1101 1102 24 346 347 181 344 345 1058 1075 1073 1075 1095 1096 1072 298 3086 3087 153 160 1065 326 2 2 2 348 182 280 27 145 146 147 146 147 146 280 3088 3087 280 27 145 146 189 190 191 189 3086 3087 1065 1058 1055 298 349 23 350 1055 1065 1150 1151 1152 1072 245 248 247 246 247 248 247 246 253 254 253 254 351 352
1061 245 248 247 248 351 352 247 248 247 248 247 248 1061 1066 1071 1066 1136 1137 1055 21 3086 3087 194 195 1072 353 220 221 220 347 182 164 27 152 160 288 289 286 287 164 3088 3087 164 27 152 160 189 210 211 189 3086 3087 1072 1061 1099 21525 21526 21527 21528 1100 1072 1153 1130 1154 1055 272 266 267 266 267 266 267 266 267 266 267 266 267 266
1058 272 266 267 266 267 266 267 266 267 266 267 266 1058 1128 1073 1075 1107 1108 1058 21 3086 3087 183 184 1055 163 182 190 191 192 193 189 28 163 182 354 355 356 357 189 3088 3087 189 28 163 182 189 192 193 189 3086 3087 1055 298 153 358 22 23 180 359 1055 1155 1053 1156 1058 4114 4115 1098 1097 1098 1097 1098 1097 1098 1097 1098 1097 1103 1104
1061 1098 1097 1098 1097 1103 1104 1098 1097 1098 1097 1098 1097 1061 1135 1071 1066 1069 1070 1061 21 3086 3087 196 197 1058 245 248 309 310 247 248 259 27 245 248 316 317 247 246 259 3088 3087 259 27 245 248 259 247 248 259 3086 3087 1064 21 330 331 22 23 180 181 1058 1147 1148 1149 1061 3086 3087 1067 1068 1055 1055 1147 1148 1149 1067 1068 1067 1068 1067
1067 1068 1093 1094 1127 1128 1107 1108 1055 1139 1140 1105 1106 1112 1113 1095 1096 1093 1094 1064 21 3086 3087 360 361 1061 272 266 267 266 267 266 275 28 272 266 322 266 267 266 275 3088 3087 275 28 272 266 275 267 266 275 3088 3089 1065 21 362 363 22 23 364 365 1061 1144 1110 1146 1058 3086 3087 335 147 146 147 146 147 146 147 146 147 146 1064
1112 1113 1118 1119 1134 1135 1069 1070 1147 1148 1149 1114 1115 1123 1124 1136 1137 1118 1119 1065 21 3086 3087 366 367 1055 1098 1097 1098 1097 1098 1097 1098 1097 1098 1050 1098 1097 1098 1097 1098 1097 1098 1097 1050 1098 1097 1098 1097 1098 1097 1098 1097 1072 21 368 369 22 23 370 371 1055 1150 1121 1157 1061 3086 3087 298 153 160 153 160 155 154 153 160 153 160 1065
1123 1124 1064 1098 1097 1098 1097 1064 1075 1139 1140 1107 1108 1139 1140 1073 1075 1073 1075 1072 21 3086 3087 372 373 1067 1068 1055 1055 1147 1148 1149 1067 1068 1147 1148 1149 1067 1068 1055 1055 1147 1148 1149 1067 1068 1147 1148 1149 1067 1068 1147 1148 1149 21 374 348 22 23 180 181 1058 1067 1068 1058 1058 3086 3087 21 177 178 179 170 375 376 177 178 179 170 1072
1139 1140 1065 145 146 147 146 41 42 43 44 45 46 43 44 47 42 47 42 32802 21 3086 3087 377 378 27 145 146 147 146 147 146 147 146 147 28 145 146 147 146 147 146 147 146 28 145 146 147 146 147 146 147 146 28 21 379 380 22 23 180 1055 1061 1055 1055 1061 1061 3086 3087 21 236 2 2 201 337 338 236 2 2 201 1055
1093 1094 1072 152 1101 1102 160 48 49 50 51 52 53 49 51 54 55 56 57 32805 21 3086 3087 180 181 28 152 160 284 381 382 383 290 291 153 27 152 160 384 285 290 291 286 287 27 152 160 155 154 290 291 385 386 27 21 183 184 22 23 24 387 350 388 350 388 350 3086 3087 21 223 224 221 225 190 191 219 220 389 390 1058
1118 1119 1055 245 352 351 248 31 47 58 42 59 60 47 42 61 62 63 64 32808 391 3086 3087 247 248 27 245 248 392 393 394 395 247 246 247 28 245 248 396 397 247 246 309 310 28 245 248 253 254 247 246 398 399 28 391 253 254 22 23 247 248 247 248 247 248 247 3086 3087 391 253 254 247 248 309 310 247 248 253 254 1061
1073 1075 1058 272 266 322 266 34 51 65 66 67 68 69 70 71 72 67 68 32809 400 3086 3087 267 266 28 272 266 322 266 322 266 322 266 267 27 272 266 322 266 322 266 322 266 27 272 266 322 266 322 266 322 266 27 400 267 266 22 23 267 266 267 266 267 266 267 3086 3087 400 267 266 267 266 267 266 267 266 267 266 1058
1071 1066 1061 1098 1103 1104 1098 1061 1055 1116 1117 1158 1159 1118 1119 1136 1137 1158 1159 1072 1098 1097 1098 1097 1098 1050 1098 1097 1098 1097 1098 1097 1098 1097 1098 1050 1098 1097 1098 1097 1098 1097 1098 1097 1050 1098 1097 23577 23577 23577 23577 1098 1097 1050 1097 1098 1160 329 23 1160 1098 1097 1098 1097 1098 1097 1098 1097 1098 1097 1098 23577 23577 23577 23577 1098 1097 1098 1097 1061
1073 1074 1074 1075 1091 1092 1073 1074 1075 1089 1090 1112 1113 1073 1075 1073 1075 1093 1094 1055 1055 1161 1162 1163 1164 1055 1147 1148 1149 1161 1162 1163 1164 1055 1147 1148 1149 1161 1162 1163 1164 1055 1147 1148 1149 1067 1068 25 25 25 25 1055 1161 1162 1163 1164 1055 21524 21524 1055 1147 1148 1149 1067 1068 1147 1161 1162 1163 1164 1055 25 25 25 25 1055 1161 1162 1163 1164
1071 1082 1082 1066 1158 1159 1071 1082 1066 1116 1117 1123 1124 1071 1066 1071 1066 1118 1119 1055 25 1165 1166 1167 1168 25 25 25 25 1165 1166 1167 1168 25 25 25 25 1165 1166 1167 1168 25 25 25 25 25 25 25 25 25 25 25 1165 1166 1167 1168 1160 1098 1097 1160 25 25 25 25 25 25 1165 1166 1167 1168 25 25 25 25 25 25 1165 1166 1167 1168
