48 64
0 12 13 14 15 0 0 0 0 0 0 0 0 0 0 0 0 0 0 12 13 14 16 0 0 0 0 0 0 0 0 12 13 14 16 0 0 0 0 0 0 0 0 12 13 14 15 0
0 17 18 19 20 0 0 0 0 0 0 0 0 0 0 0 0 0 0 17 18 19 21 0 0 0 0 0 0 0 0 17 18 19 21 0 0 0 0 0 0 0 0 17 18 19 20 0
22 23 24 25 22 23 22 23 22 23 22 23 22 23 22 23 22 23 22 23 26 27 22 27 22 27 22 27 22 27 22 23 26 28 29 30 31 30 31 30 31 30 31 32 26 28 33 32
1059 4130 4131 1058 49187 34 35 34 35 50210 1059 1058 1059 1058 1059 1058 1059 1058 1059 49186 35 34 35 50210 1059 1058 1059 1058 1059 1058 1059 1058 1059 49186 35 34 35 34 35 34 35 34 35 50210 1059 1058 1059 1058
1075 3124 3123 1076 1075 1076 1075 1076 1075 1076 1075 1076 1075 1076 1075 1076 1075 1076 1075 1076 1075 1076 1075 1076 1075 1076 1075 1076 1075 1076 1075 1076 1075 1076 1075 1076 1075 1076 1075 1076 1075 1076 1075 1076 1075 1076 1075 1076
1077 3131 3130 1078 1079 1080 1081 1078 1082 1077 1083 1082 1078 1079 1080 1081 1078 1082 1077 1083 1082 1078 1079 1080 1081 1078 1082 1077 1083 1082 1078 1079 1080 1081 1078 1082 1077 1083 1082 1078 1079 1080 1081 1078 1082 1077 1083 1082
1084 3138 3137 1085 1086 1087 1088 1085 1089 1084 1090 1089 1085 1086 1087 1088 1085 1089 1084 1090 1089 1085 1086 1087 1088 1085 1089 1084 1090 1089 1085 1086 1087 1088 1085 1089 1084 1090 1089 1085 1086 1087 1088 1085 1089 1084 1090 1089
1091 3144 3126 1092 1093 1094 1095 1092 1078 1091 1096 1078 1092 1093 1094 1095 1092 1078 1091 1096 1078 1092 1093 1094 1095 1092 1078 1091 1096 1078 1092 1093 1094 1095 1092 1078 1091 1096 1078 1092 1093 1094 1095 1092 1078 1091 1096 1078
1078 3145 3126 1097 1078 1078 1097 1078 1097 1078 1078 1097 1078 1097 1078 1097 1078 1097 1078 1097 1097 1097 1097 1078 1097 1089 1097 1089 1097 1078 1097 1089 1097 1078 1097 1089 1097 1089 1097 1078 1097 1089 1097 1082 1078 1097 1078 1082
1097 3126 3145 1078 1097 1097 1078 1097 1078 1097 1097 1078 1097 1078 1097 1078 1097 1078 1097 1098 1099 1100 1098 1099 1100 1101 1102 1098 1099 1100 1101 1102 1098 1099 1100 1101 1102 1098 1099 1100 1101 1102 1098 1078 1097 1078 1097 1085
1078 3145 3126 1078 1085 1078 1097 1078 1078 1085 1078 1097 1078 1078 1078 1097 32822 32822 32829 32868 0 0 0 0 0 0 0 0 0 0 0 0 0 0 0 0 0 0 0 0 0 0 32868 1097 1078 1078 1085 1089
1097 3126 3145 1097 1092 1097 1078 1097 1097 1092 1097 1078 1097 1097 1097 1078 32841 32841 32836 32869 0 0 0 0 0 0 0 0 0 0 0 0 0 0 0 0 0 0 0 0 0 0 32869 1078 1097 1078 1078 1078
1092 3145 3133 1082 1085 1092 1097 1085 1082 1085 1092 1097 1085 1082 1092 1097 32829 32826 32836 32868 0 0 0 104 0 0 0 0 0 104 0 0 0 0 0 104 0 0 0 0 0 104 32868 1097 1085 1078 1078 1085
1085 3145 3140 1097 1078 1085 1097 1092 1097 1078 1085 1097 1092 1097 1085 1097 32836 32841 32822 32869 0 36 0 105 0 0 37 0 0 105 106 107 0 38 0 105 0 0 37 0 0 105 32869 1097 1092 1097 1078 1092
1097 3126 3133 1078 1097 1097 1078 1085 1078 1097 1097 1078 1085 1078 1097 1078 32836 32822 32841 32868 0 39 0 108 10 109 40 0 0 108 110 111 0 41 0 108 0 0 40 0 0 108 32868 1078 1082 1078 1097 1103
1085 3145 3140 1097 1078 1078 1097 1078 1097 1078 1078 1097 1078 1104 1104 1104 1104 1104 1104 1104 1104 1104 1104 1104 4104 4105 1104 1104 1104 1104 1104 1104 1104 1104 1104 1104 1104 1104 1104 1104 1104 1104 1104 1104 1104 1104 1104 1092
1097 3126 3133 1078 1097 1097 1078 1097 1078 1097 1097 1078 1097 1078 1097 1078 1097 1097 1097 1085 1078 1097 1085 1078 3080 3081 1097 1085 1078 1097 1085 1078 1097 1085 1078 1097 1085 1078 1097 1085 1078 1097 1085 1092 1078 1085 1097 1078
1078 3145 3126 1097 1078 1078 1097 1078 1078 1085 1078 1097 1078 1078 1085 1097 1078 1097 1078 1097 1085 1078 1078 1098 3080 3081 1098 1098 1100 1101 1098 1099 1100 1098 1101 1102 1098 1099 1100 1098 1099 1100 1098 1101 1102 1099 1098 1105
1097 3126 3145 1078 1097 1097 1078 1097 1097 1092 1097 1078 1097 1097 1092 1078 1097 32822 32822 32829 32833 32833 32853 0 3080 3081 0 0 0 0 0 0 0 0 0 0 0 0 0 0 0 0 0 0 0 0 0 1105
1078 3145 3126 1078 1085 1092 1097 1085 1082 1085 1092 1097 1085 1082 1085 1097 1078 32841 32822 32822 32822 32826 32853 0 3080 3081 0 0 0 0 0 0 0 0 0 0 0 0 0 0 0 0 0 0 0 0 0 1105
1097 3126 3145 1097 1092 1085 1097 1092 1097 1078 1085 1097 1092 1097 1078 1092 1097 32829 32822 32822 32829 32833 32853 0 3080 3081 0 0 0 0 0 0 0 0 0 0 0 0 0 0 0 0 0 0 0 0 0 1105
1092 3145 3126 1082 1085 1097 1078 1097 1078 1097 1097 1078 1085 1097 1078 1085 1097 32836 32841 32822 32836 32822 32853 0 3080 3081 0 0 0 0 0 0 0 0 0 0 0 0 0 0 0 0 0 0 0 0 0 1105
1078 3126 3133 1089 1097 1078 1078 1085 1089 1078 1078 1085 1106 1107 1108 1078 1085 32826 32822 32841 32847 32833 32853 0 3080 3081 0 0 0 0 0 0 0 0 0 0 0 0 0 0 0 0 0 0 0 0 0 1105
1078 3126 3140 1078 1089 1097 1078 1092 1078 1097 1078 1092 1109 1110 1105 1078 1092 32833 32836 32839 1092 1089 1089 1104 1104 1104 1104 1104 1104 1104 1104 1104 1104 1104 1104 1104 1104 1104 1104 1104 1111 1104 10240 10240 10240 10240 10240 1105
1097 3150 3137 1099 1100 1101 1102 1089 1099 1100 1101 1102 1109 1067 1105 1100 1101 32822 32829 32841 1078 1085 1112 1097 1085 1097 1097 1078 1097 1097 1097 1085 1097 1097 1085 1097 1097 1078 1097 1097 1078 1109 0 0 0 0 0 1105
1109 3080 3081 12288 0 0 0 0 0 0 0 0 42 43 44 0 0 32833 32841 32841 1078 1078 1085 1097 1078 1085 1097 1078 1085 1097 1098 1099 1100 1101 1102 1098 1099 1100 1101 1102 1098 1109 0 0 0 0 0 1105
1109 3080 3081 12288 0 0 0 0 0 0 0 0 42 43 44 0 0 32849 32829 32826 32822 32841 32826 32822 32841 32822 32822 32822 32826 32853 12288 0 0 0 0 0 0 0 0 0 1105 1109 0 0 0 0 0 1105
1109 3080 3081 12288 104 0 0 0 0 0 104 0 45 46 47 0 104 32849 32836 32833 32836 32839 32833 32836 32839 32822 32822 32829 32833 32853 12288 0 0 0 0 0 0 0 0 0 1105 1109 0 0 0 0 0 1105
1109 3080 3081 12288 105 0 0 38 0 0 105 0 42 43 44 0 105 32849 32826 32822 32836 32841 32822 32836 32841 32841 32822 32836 32822 32853 12288 0 0 0 0 0 0 0 0 0 1105 1109 0 0 0 0 0 1105
1109 3080 3081 12288 108 0 0 41 0 0 108 0 45 46 47 0 108 32849 32833 32833 32841 32841 32833 32841 32841 32822 32841 32847 32833 32853 12288 0 0 0 0 0 0 0 0 0 1105 1109 0 0 0 0 0 1105
1109 0 0 0 1104 1104 1104 1104 1104 1104 1104 1104 1104 1070 1104 1104 1104 1104 1104 1104 1104 1104 1104 1104 1104 1104 1104 1104 1104 1104 0 0 0 0 0 0 0 0 0 0 48 1109 0 0 0 0 0 1105
1109 0 0 0 1105 1078 1085 1097 1097 1078 1097 1089 1109 1070 1105 1089 1089 1113 1078 1097 1078 1085 1078 1097 1078 1078 1097 1078 1085 49 0 0 0 0 0 0 0 0 0 0 0 0 0 0 0 0 0 1105
1109 20491 20491 20491 1105 1078 1085 1085 1078 1097 1085 1097 1114 1067 1115 1085 1089 1085 1078 1097 1085 1097 1097 1078 1097 1097 1097 1089 49 0 0 0 0 0 0 0 0 0 0 0 0 0 0 0 0 0 0 1105
1109 1097 1097 1097 1105 1085 1097 1092 1097 1078 1092 1109 1116 1117 1116 1105 1089 1092 1097 1078 1097 1085 1078 1097 1085 1078 1097 49 0 0 0 0 0 0 0 0 0 0 0 0 0 0 0 0 0 0 0 1105
1078 1085 1097 1097 1078 1097 1078 1085 1097 1097 1078 1118 1119 1120 1119 1121 1089 1097 1097 1078 1078 1092 1097 1078 1092 1097 1109 0 0 0 0 0 0 0 0 0 0 0 0 0 0 0 0 0 0 0 0 1105
1078 1106 1107 1107 1107 1108 1097 1078 1097 1097 1082 1097 1078 1082 1097 1082 1097 1089 1078 1097 1097 1082 1097 1078 1082 1097 1109 0 0 0 1104 1104 1104 1104 1104 0 0 0 0 1104 1104 49254 0 0 0 1104 1104 1105
1097 1109 0 0 0 1105 1078 1097 1078 1085 1089 1078 1097 1089 1078 1089 1078 1078 1097 1078 1085 1089 1078 1097 1089 1078 1109 0 0 0 48 1089 1089 1089 1109 0 10240 10240 0 1105 1089 1097 49254 0 0 48 1089 1105
1085 1109 0 0 0 1105 1097 1082 1077 1083 1082 1078 1079 1080 1081 1078 1082 1077 1083 1082 1078 1079 1080 1081 1078 1082 1109 0 0 0 0 0 1105 1085 1109 0 0 0 0 1105 1082 1085 1109 0 0 0 48 1105
1092 1109 0 0 0 1105 1097 1089 1084 1090 1089 1085 1086 1087 1088 1085 1089 1084 1090 1089 1085 1086 1087 1088 1085 1089 1109 0 0 0 0 0 1105 1092 1109 20491 20491 20491 20491 1105 1089 1089 1109 0 0 0 0 1105
1097 1109 0 0 0 1105 1085 1078 1091 1096 1078 1092 1093 1094 1095 1092 1078 1091 1096 1078 1092 1093 1094 1095 1092 1078 1109 0 0 0 0 0 1105 1097 1109 1111 1111 1111 1111 1105 0 0 0 0 0 0 0 1105
1097 1109 0 0 0 48 1098 1099 1100 1101 1102 1098 1099 1100 1101 1102 1098 1099 1100 1101 1102 1098 1099 1100 1101 1102 1098 0 0 0 1104 1104 1092 1092 1085 1078 1078 1078 1078 1082 0 0 104 0 0 0 0 1105
1078 1109 0 0 0 0 0 0 0 0 0 0 0 0 0 0 0 0 0 0 0 0 0 0 0 0 0 0 0 0 1105 1097 1097 1092 1092 1082 1092 1085 1082 1097 0 0 108 10240 10250 109 0 1105
1078 1109 0 0 0 0 0 0 0 0 0 0 104 0 0 0 0 0 0 0 0 0 0 0 0 0 104 0 0 0 1105 1085 1082 1092 1089 1085 1082 1092 1089 1092 1097 1097 1097 1104 4104 4105 1104 1085
1085 1109 0 0 0 0 0 0 0 38 0 0 105 0 0 0 36 0 0 104 0 0 0 37 0 0 105 0 0 0 1105 1092 1089 1085 1097 1097 1097 1097 1097 1097 1085 1082 1092 1109 3080 3081 1105 1092
1078 1109 0 0 0 0 0 0 50 41 0 0 108 0 0 0 39 0 0 108 0 0 0 40 0 0 108 0 0 0 1105 1078 1078 1097 1085 1082 1092 1085 1082 1092 1092 1089 1085 1109 3080 3081 1105 1097
1078 1109 0 0 0 50279 1104 1104 1104 1104 1104 1104 1104 1104 1104 1104 1104 1104 1104 1104 1104 1104 1104 1104 1104 1104 1104 1104 1104 1104 1122 1097 1097 1097 1092 1089 1097 1097 1097 1085 1078 1078 1097 1109 3080 3081 1105 1085
1085 1109 0 0 0 1105 1078 1078 1097 1097 1082 1078 1097 1097 1097 1078 1078 1078 1097 1097 1097 1078 1078 1097 1078 1078 1078 1097 1097 1097 1123 1097 1097 1097 1097 1097 1085 1082 1092 1097 1097 1078 1097 1109 3080 3081 1105 1092
1097 1109 0 0 0 1105 1097 1097 1078 1085 1089 1078 1092 1097 1085 1097 1085 1078 1092 1097 1085 1097 1085 1085 1097 1085 1078 1092 1097 1085 1097 1085 1082 1092 1085 1082 1092 1089 1085 1082 1092 1082 1092 1109 3080 3081 1105 1078
1078 1109 0 0 0 1105 1092 1078 1097 1097 1097 1097 1085 1097 1092 1097 1092 1097 1085 1097 1092 1097 1097 1097 1092 1106 1107 1108 1097 1092 1097 1092 1089 1085 1092 1089 1106 1107 1108 1089 1085 1089 1085 1109 3080 3081 1105 1092
1078 1109 0 0 0 1105 1085 1078 1092 1097 1097 1078 1078 1078 1097 1078 1085 1078 1078 1078 1097 1078 1078 1078 1097 1109 1110 1105 1078 1097 1092 1078 1078 1097 1078 1085 1109 1110 1105 1078 1097 1078 1097 1109 3080 3081 1105 1097
1097 1109 0 0 0 1105 1078 1097 1085 1097 1109 1098 1099 1100 1101 1102 1098 1099 1100 1101 1102 1098 1099 1100 1101 1109 1067 1105 1100 1101 1102 1098 1099 1100 1101 1102 1109 1067 1105 1101 1102 1098 1101 1102 3080 3081 1105 1085
1078 1109 0 0 0 1105 1085 1078 1078 1078 1109 0 0 0 0 0 0 0 0 0 0 0 0 0 0 42 43 44 0 0 0 0 0 0 0 0 42 43 44 0 0 0 0 0 3080 3081 1105 1092
1092 1109 0 0 0 1105 1097 1078 1097 1097 1109 112 113 0 104 0 0 0 0 0 0 0 0 0 104 45 46 47 0 104 0 0 0 0 36 104 45 46 44 37 0 0 104 0 3080 3081 1105 1078
1085 1109 0 0 0 1105 1097 1078 1092 1097 1109 0 0 0 108 0 0 0 0 0 0 0 0 0 108 45 43 47 0 108 10 109 0 0 39 108 45 43 47 40 0 0 108 0 3080 3081 1105 1092
1078 1109 0 0 0 1105 1092 1097 1085 1097 1097 1104 1104 1104 1104 1104 1104 1104 1104 1104 1104 1104 1104 1104 1104 1104 1070 1104 1104 1104 4104 4105 1104 1104 1104 1104 1104 1070 1104 1104 1104 1104 1104 1104 1104 1104 1089 1097
1097 1109 0 0 0 1105 1085 1097 1092 1097 1085 1097 1097 1092 1097 1085 1097 1106 1107 1108 1097 1092 1097 1085 1097 1114 1067 1115 1085 1109 3080 3081 1105 1092 1097 1085 1114 1067 1115 1097 1089 1085 1078 1078 1092 1085 1078 1085
1078 1109 0 0 0 1105 1105 1078 1085 1078 1078 1078 1078 1085 1078 1078 1078 1109 1110 1105 1078 1085 1078 1078 1109 1116 1117 1116 1105 1109 3080 3081 1105 1085 1078 1109 1116 1117 1116 1105 1085 1097 1097 1078 1112 1097 1097 1092
1085 1109 0 0 0 48 1102 1098 1099 1100 1101 1102 1098 1099 1100 1101 1102 1109 1067 1105 1100 1101 1098 1099 1100 1101 1102 1098 1099 1098 3080 3081 1098 1099 1100 1101 1102 1098 1099 1100 1078 1082 1097 1097 1097 1082 1092 1078
1097 1109 0 0 0 0 0 0 0 0 0 0 0 0 0 0 0 42 43 44 0 0 0 0 0 0 0 0 0 0 3080 3081 0 0 0 0 0 0 0 0 32868 32822 32822 32829 1097 1089 1085 1089
1078 1109 0 0 0 0 0 0 0 0 0 0 0 0 0 0 0 45 46 47 0 0 0 0 0 0 0 0 0 0 3080 3081 0 0 114 0 0 0 0 0 32869 32841 32841 32836 1085 1078 1097 1078
1078 1109 0 0 0 0 0 104 0 0 0 0 0 0 104 0 0 45 43 44 0 104 0 0 0 0 0 0 104 0 3080 3081 0 0 0 104 0 0 0 0 32868 32829 32826 32829 1097 1097 1078 1097
1097 1109 0 0 0 0 0 105 0 0 0 37 0 0 105 0 0 42 46 44 0 105 0 0 0 0 0 0 105 0 3080 3081 0 0 0 105 0 0 0 37 32869 32836 32841 32822 1082 1092 1082 1089
1097 1109 0 0 0 0 0 108 0 0 0 40 0 0 108 0 0 45 43 47 0 108 50 0 0 0 0 0 108 0 3080 3081 0 0 0 108 0 50 0 40 32868 32829 32822 32841 1089 1085 1089 1089
1078 1078 1104 1104 1104 1104 1104 1104 1104 1104 1104 1104 1104 1104 1104 1104 1104 1104 1070 1104 1104 1104 1104 1104 1104 1104 1104 1104 1104 1104 1104 1104 1104 1104 1104 1104 1104 1104 1104 1104 1104 1089 1085 1089 1078 1097 1078 1113
