48 48
0 21 22 23 24 0 0 0 0 0 0 0 0 0 0 0 0 0 0 21 22 23 25 0 0 0 0 0 0 0 0 21 22 23 25 0 0 0 0 0 0 0 0 21 22 23 24 0
0 26 27 28 29 0 0 0 0 0 0 0 0 0 0 0 0 0 0 26 27 28 30 0 0 0 0 0 0 0 0 26 27 28 30 0 0 0 0 0 0 0 0 26 27 28 29 0
31 32 33 34 31 32 31 32 31 32 31 32 31 32 31 32 31 32 31 32 35 36 31 36 31 36 31 36 31 36 31 32 35 37 38 39 40 39 40 39 40 39 40 41 35 37 42 41
4140 4139 1068 1067 49196 43 44 43 44 50219 1068 1067 1068 1067 1068 1067 1068 1067 1068 49195 44 43 44 50219 1068 1067 1068 1067 1068 1067 1068 1067 1068 49195 44 43 44 43 44 43 44 43 44 50219 1068 1067 1068 1067
3146 3147 1098 1099 1098 1099 1098 1099 1098 1099 1098 1099 1098 1099 1098 1099 1098 1099 1098 1099 1098 1099 1098 1099 1098 1099 1098 1099 1098 1099 1098 1099 1098 1099 1098 1099 1098 1099 1098 1099 1098 1099 1098 1099 1098 1099 1098 1099
3124 3124 1076 1076 1076 1076 1076 1076 1076 1076 1076 1076 1076 1076 1076 1076 1076 1076 1076 1076 1076 1076 1076 1076 1076 1076 1076 1076 1076 1076 1076 1076 1076 1076 1076 1076 1076 1076 1076 1076 1076 1076 1076 1076 1076 1076 1076 1076
3148 3148 1100 1100 1100 1100 1100 1100 1100 1100 1100 1100 1100 1100 1100 1100 1100 1100 1100 1100 1100 1100 1100 1100 1100 1100 1100 1100 1100 1100 1100 1100 1100 1100 1100 1100 1100 1100 1100 1100 1100 1100 1100 1100 1100 1100 1100 1077
3080 3081 0 0 0 0 0 0 0 0 0 0 0 0 0 0 0 0 0 117 118 119 0 0 0 0 0 0 0 0 0 0 0 0 0 120 121 0 0 0 0 0 0 0 0 45 1101 1077
3082 3083 0 0 0 0 0 0 0 0 0 0 0 0 0 0 0 0 0 0 122 0 0 0 0 0 0 0 0 0 0 0 0 0 0 16 17 0 0 0 0 0 0 0 0 0 1101 1077
3084 3085 0 0 0 0 0 0 0 0 0 0 0 0 0 0 0 0 0 0 123 0 0 0 0 0 0 0 0 0 0 0 0 0 0 16 17 0 0 0 0 0 0 0 0 0 1101 1077
3082 3083 0 0 0 0 0 0 0 0 0 0 0 0 0 0 0 0 0 0 122 0 0 0 0 0 0 0 0 0 0 0 0 0 0 16 17 0 0 0 0 0 0 0 0 0 1101 1077
12 13 0 0 0 0 0 0 0 0 0 0 0 0 0 0 0 0 0 0 123 0 0 0 0 0 0 0 0 0 0 0 0 0 0 16 17 0 0 0 0 0 0 0 0 0 1101 1077
10 11 0 0 0 0 0 0 0 0 0 0 0 0 0 0 0 0 0 0 122 0 0 0 0 0 0 0 0 0 0 0 0 0 0 16 17 0 0 0 0 0 0 0 0 0 1101 1077
12 13 0 0 0 0 0 0 0 0 0 0 0 0 0 0 0 0 0 0 123 0 0 0 0 0 0 0 0 0 0 0 0 0 0 16 17 0 0 0 0 0 0 0 0 0 1101 1077
124 125 0 0 0 0 0 0 0 0 0 0 0 0 0 0 0 0 0 126 127 128 0 0 0 0 0 0 0 0 0 0 0 0 0 16 17 0 0 0 0 0 0 0 0 0 1101 1077
1100 1100 1100 1100 1100 0 0 0 0 0 0 0 0 0 0 0 0 0 50291 1100 1100 1100 49266 0 0 0 0 0 0 1100 1100 1100 1100 0 0 16 17 0 0 0 0 0 0 0 50292 1077 1077 1077
1076 1076 1087 1076 1076 0 0 0 0 0 0 0 0 0 0 0 0 50291 1102 1076 1076 1076 1103 49266 0 0 0 0 0 45 1077 1077 46 0 0 16 17 0 0 0 0 0 0 0 1104 1105 1077 1077
1077 1106 1107 1107 1108 1100 1100 11264 11264 11264 11264 11264 11264 11264 11264 11264 1100 1102 1077 1109 1110 1077 1076 1103 49266 0 0 0 0 0 0 0 0 0 0 11280 11281 0 0 0 0 0 0 0 129 1111 1112 1077
1113 1086 47 47 1101 1080 1086 0 0 0 0 0 0 0 0 0 1101 1087 1114 1115 1116 1077 1077 1077 1103 49266 0 0 0 0 0 0 0 0 0 11280 11281 0 0 0 0 0 0 0 1117 1118 1077 1077
1077 1086 48 48 1101 1080 1086 20498 20498 20498 20498 20498 20498 20498 20498 20498 1101 1080 1081 1119 1120 1112 1077 1077 1076 1103 1100 1100 1100 1100 1100 0 0 0 0 0 0 0 0 0 0 0 0 0 45 1077 1077 1077
130 49 50 50 51 1080 1113 1100 1100 1100 1100 1100 1100 1100 1100 1100 1113 1085 1077 1085 1078 1085 1077 1077 1112 1077 1114 1121 1122 1077 46 0 0 0 0 0 0 0 0 0 0 0 0 0 0 45 1112 1077
1086 131 48 48 132 1101 1080 1077 1112 1077 1112 1088 1079 1088 1079 1080 1080 1077 1076 1112 1077 1077 1076 1077 1077 1079 1081 1082 1123 46 0 0 0 0 0 10240 10240 0 0 0 0 0 0 0 0 0 1101 1077
1086 133 50 50 134 1101 1077 1084 1078 1085 1076 1087 1076 1076 1124 1080 1080 1080 52 1085 1080 1080 1076 1087 1076 1076 1084 1078 1086 20480 20480 20480 20480 20480 20480 0 0 20480 20480 20480 20480 20480 20480 0 135 136 1101 1080
1086 1125 1126 1126 1125 1101 1080 1112 130 1112 1077 1080 1112 1077 1127 1077 1077 1080 53 1087 1085 1077 1077 1080 1112 1077 1077 1077 1086 1100 1100 1100 1100 1100 1100 0 0 1100 1100 1100 1100 1100 1100 1100 4110 4111 1101 1085
1086 1128 1129 1129 1128 1101 1080 1084 1078 1085 130 1121 1122 1077 1080 1080 1080 1084 54 1085 1077 1076 1114 1121 1122 1077 1084 1078 1076 1081 1082 1123 1087 1087 1087 0 0 1077 1085 1078 1085 1076 1076 1086 3086 3087 1101 1077
1077 1113 1127 1077 1077 1080 1077 1077 1113 1113 1113 1082 1123 1112 1079 1114 1121 1082 1123 1112 1080 1077 1081 1082 1123 1112 1112 1114 1077 1087 1076 1076 1112 1077 1080 1100 1100 1076 1112 1077 1077 1112 1077 1086 3086 3087 1101 1077
1080 1086 0 0 0 0 45 55 56 56 56 55 55 55 55 57 58 55 55 55 56 53 52 52 52 1076 1084 1078 1077 1080 1114 1121 1122 1114 1121 1122 1076 1076 1085 1080 1080 1114 53 1086 3086 3087 1101 1077
1080 1086 0 0 0 0 0 59 0 0 59 0 0 59 0 0 59 0 0 0 59 0 0 0 59 56 56 55 55 55 55 57 55 60 60 54 61 60 54 61 60 54 61 62 3086 3087 1101 1077
1076 1086 0 0 0 0 0 52 63 52 52 52 52 52 60 54 61 53 64 55 65 0 0 0 65 60 54 61 0 59 0 0 59 53 53 53 53 53 53 53 53 53 53 62 3086 3087 1101 1077
1077 1086 0 0 0 0 0 1077 1080 1112 1077 1077 1112 1077 1077 1077 1077 1087 1076 1076 53 53 53 53 53 53 53 53 52 52 60 54 52 61 54 61 53 54 61 53 54 61 53 62 3086 3087 1101 1077
1113 1076 1100 1100 1100 1100 1113 1114 1121 1122 1077 1084 1078 1114 1121 1122 1077 1114 1121 1122 1077 1114 1077 1080 1112 1077 1087 1076 1076 1080 1112 1080 1112 1076 1085 1080 1080 1114 1112 1077 1080 1112 1077 1086 3086 3087 1101 1114
1080 1077 1080 1081 1082 1123 1080 1081 1082 1123 1112 1077 1080 1081 1082 1123 1080 1081 1082 1123 1087 1087 1080 1077 1077 1077 1080 1112 1077 1084 1078 1085 1077 53 63 61 53 1078 1085 1114 1121 1122 1077 1086 3086 3087 1101 1112
1077 1130 1131 1132 1133 1077 1133 1131 1133 1134 1077 1130 1131 1132 1134 1077 1130 1133 1132 1133 1077 1133 1131 1132 1134 1077 1077 1077 1077 1077 1077 1077 1077 1077 1077 1077 1077 1113 1113 1113 1082 1123 1112 1086 3086 3087 1101 1077
1086 137 130 138 0 0 0 0 0 139 0 0 0 0 117 118 119 0 0 0 0 0 137 130 138 1101 1086 1077 1130 1131 1132 1134 1077 1130 1131 1132 1134 1077 1130 1131 1132 1134 1077 1086 3086 3087 1101 1077
1086 137 0 138 0 0 0 0 66 140 67 0 0 68 0 123 0 0 0 0 0 0 137 0 138 1101 1086 46 0 0 0 117 118 119 32787 0 0 0 0 0 0 117 118 119 3086 3087 1101 1077
1086 137 130 138 0 0 0 0 69 141 70 135 136 71 126 127 128 72 0 0 72 0 137 130 138 1101 1086 0 0 0 0 0 122 0 32788 0 0 0 0 0 0 0 122 0 3086 3087 1101 1077
1086 1100 1100 1100 1100 1100 1100 1100 1100 1100 1100 4110 4111 1100 1100 1100 1100 1100 1100 1100 1100 1100 1100 1100 1100 1101 1086 0 0 0 0 0 123 0 32787 0 0 0 0 0 0 0 123 0 3086 3087 1101 1077
1086 1130 1131 1132 1134 1077 1130 1131 1132 1134 46 3086 3087 45 1130 1131 1132 1134 1077 1130 1131 1132 1134 1077 1077 1101 1086 0 0 0 0 0 122 0 32788 0 0 0 139 0 0 0 122 0 3086 3087 1101 1077
1086 137 130 138 0 0 0 117 118 119 0 3086 3087 0 0 0 0 0 139 0 0 0 137 130 138 1101 1086 0 0 0 0 0 123 0 32787 0 0 66 140 67 0 0 123 0 3086 3087 1101 1080
1086 137 0 138 0 0 0 0 123 0 0 3086 3087 0 0 0 0 66 140 67 0 0 137 0 138 1101 1086 135 136 0 0 126 127 128 32788 0 73 69 141 70 72 126 127 128 3086 3087 1101 1077
1086 137 130 138 0 0 72 126 127 128 0 3086 3087 0 0 135 136 69 141 70 0 0 137 130 138 1101 1086 4110 4111 1135 1135 1135 1135 1135 1135 1135 1135 1135 1135 1135 1135 1135 1135 1135 1135 1135 1077 1077
1086 1100 1100 1100 1100 1100 1100 1100 1100 1100 1100 1100 1100 1100 1100 4110 4111 1100 1100 1100 1100 1100 1100 1100 1100 1100 1086 3086 3087 1077 1084 1078 1085 1077 1077 1077 1077 1077 1080 1106 1107 1107 1107 1107 1108 1077 1077 1080
1086 1077 1077 1077 1077 1130 1131 1132 1134 1077 1130 1131 1132 1134 46 3086 3087 45 1077 1132 1134 1077 1130 1131 1132 1134 46 3086 3087 1077 1087 1078 1085 1076 1076 1076 1076 1087 1087 1086 47 47 47 47 1136 1114 1121 1122
1086 0 0 0 0 0 0 0 0 0 117 118 119 0 0 3086 3087 0 0 0 0 32787 0 0 0 0 0 3086 3087 45 1080 1114 1112 1077 1084 1078 1085 1080 1080 1086 48 48 48 48 1137 1081 1082 1123
1086 142 143 0 0 0 0 0 0 0 0 122 0 0 0 3086 3087 0 139 0 0 32788 0 0 0 0 0 3086 3087 0 32821 32823 0 139 0 0 0 0 1086 49 50 50 50 50 51 1101 1077 1077
1086 0 0 0 0 0 0 0 0 68 0 123 0 0 0 3086 3087 66 140 67 0 32787 0 0 0 0 68 3086 3087 0 32831 32821 66 140 67 68 0 0 1086 131 48 48 48 48 132 1136 1077 1080
1086 72 0 0 0 0 0 0 0 71 126 127 128 0 0 3086 3087 69 141 70 0 32788 72 0 0 0 71 3086 3087 0 32824 32821 69 141 70 71 0 0 1086 133 50 50 50 50 134 1137 1077 1077
1100 1100 1100 1100 1100 1100 1100 1100 1100 1100 1100 1100 1100 1100 1100 1100 1100 1100 1100 1100 1100 1100 1100 1100 1100 1100 1100 1100 1100 1100 1077 1077 1077 1077 1077 1077 1077 1077 1086 1125 1126 1126 1126 1126 1125 1101 1077 1080
