80 48
1063 1064 1065 1066 1067 1063 1064 1065 1066 1067 1063 1064 1065 1066 1067 1063 1064 1065 1066 1067 1068 1069 1068 1068 1069 1068 1068 1069 1070 1071 1072 1067 1067 1073 1063 1064 1065 1066 1067 1074 1075 1069 1076 1074 1075 1076 1069 1076 1067 1073 1067 1069 1076 1067 1073 1067 1069 1076 1074 1075 1076 1069 1076 1074 1075 1067 1069 1073 1077 14 1078 1073 1067 1067 1073 1067 1073 1067 1067 1067
0 0 0 0 0 0 0 0 0 0 0 0 0 0 0 0 0 15 1079 1076 1079 1079 1076 1079 1076 1079 1079 1076 1080 1081 1082 1077 16 0 0 20490 20490 20490 20490 15 1064 1065 1066 1067 1063 1064 1065 1066 1067 1063 1064 1065 1066 1067 1063 1064 1065 1066 1067 1063 1064 1065 1066 1067 1063 1064 1065 1066 1077 17 1078 1063 1064 1065 1066 1067 1063 1064 1065 1067
0 0 0 0 0 0 0 0 0 0 0 0 0 0 0 0 0 0 15 1067 1068 1068 1068 1069 1083 1084 1085 1068 1086 1087 1088 1077 0 0 0 10240 10240 10240 10240 0 0 0 0 0 0 0 0 0 0 0 0 0 0 0 0 0 0 0 0 0 0 0 0 0 32780 0 0 0 18 17 19 0 0 0 0 0 0 0 0 0
0 0 0 0 97 0 0 0 97 0 0 0 0 0 0 0 97 0 0 15 1079 1076 1079 1076 1077 14 1078 1079 1067 1073 1073 1077 0 0 0 0 0 0 0 0 97 0 0 0 0 0 0 0 0 0 0 0 0 0 0 0 0 97 0 0 0 98 99 0 32781 0 97 0 20 21 22 0 99 0 0 0 0 0 0 0
23 0 0 24 100 0 0 0 100 0 0 50268 1089 49242 0 0 100 0 0 0 15 1067 1073 1073 1077 17 1078 1067 1064 1065 1066 16 0 0 0 0 0 0 0 0 100 0 25 0 0 0 0 0 0 98 0 0 0 0 0 0 0 100 0 0 0 101 102 0 32780 0 100 0 18 17 19 24 102 0 0 0 0 0 0 0
26 0 0 27 103 0 104 105 103 106 50268 1090 1079 1091 51293 52318 103 0 0 0 0 0 0 0 18 17 19 0 32781 0 0 0 0 0 0 0 0 0 0 0 103 0 28 0 54368 53343 49242 0 0 101 0 0 50268 51293 52318 0 0 103 0 29 107 108 109 0 32781 0 103 0 20 21 22 27 109 0 0 0 0 0 0 0
1089 1089 1089 1089 1089 1089 4104 4105 1089 1089 1092 1079 1079 1079 1093 1094 1089 49242 3 0 0 0 0 0 20 21 22 0 32780 0 0 0 0 0 0 0 0 0 0 1089 1089 1089 1089 1089 1095 1096 1097 49242 0 108 0 50268 1098 1093 1094 4161 4161 1089 1089 1089 1089 1089 1089 1089 1089 1089 1089 1089 1089 1045 1089 1089 1089 1089 49243 0 0 0 0 0
1079 1079 1079 1079 1079 1077 3080 3081 1078 1079 1079 1079 1079 1079 1079 1079 1079 1091 49242 0 0 0 97 0 18 17 19 0 32781 0 97 0 98 0 0 0 0 0 0 1078 1070 1071 1072 1073 1068 1073 1068 1097 1089 1089 1089 1092 1068 1073 1068 3121 3116 1073 1070 1071 1072 1073 1068 1073 1070 1071 1072 1073 30 17 31 1067 1069 1073 1077 0 0 0 0 0
1069 1070 1071 1072 1069 1077 3080 3081 1078 1068 1068 1069 1070 1071 1072 1069 1067 1099 1100 49242 3 0 100 0 18 21 19 0 32780 0 100 0 101 0 0 0 0 0 0 1078 1080 1081 1082 1069 1079 1069 1079 1069 1068 1069 1068 1069 1079 1069 1079 3117 3127 1069 1080 1081 1082 1069 1079 1069 1080 1081 1082 1077 110 21 111 1078 1076 1068 1077 0 0 0 1089 1089
1076 1080 1081 1082 1076 1077 3080 3081 1078 1079 1079 1076 1080 1081 1082 1076 1073 1079 1068 1091 51293 52318 103 112 20 17 22 0 32781 0 103 32 108 33 0 0 0 0 0 1078 1086 1087 1088 1076 1067 1076 1067 1076 1079 1076 1079 1076 1067 1076 1067 3124 3121 1076 1086 1087 1088 1076 1073 1076 1086 1087 1088 1077 1101 16467 1101 1078 1073 1079 1077 0 0 0 15 1067
1067 1086 1087 1088 1067 1077 3080 3081 1078 1073 1067 1073 1086 1087 1088 1073 1067 1073 1079 1099 1093 1094 1089 1089 1089 1045 1089 1089 1089 1089 1089 1089 1089 1089 1089 0 0 0 0 1078 1067 1073 1067 1067 1073 1067 1067 1073 1073 1073 1067 1067 1073 1073 1067 3121 3115 1067 1067 1067 1067 1068 1067 1068 1067 1073 1067 1073 1102 1103 1102 1067 1067 1067 1077 0 0 0 0 0
1073 1067 1073 1067 1073 1077 3080 3081 1078 1067 1073 1067 1073 1067 1073 1067 1073 1067 1073 1079 1073 1079 1079 1079 30 17 31 1067 1067 1073 1067 1067 1067 1073 1077 0 0 0 0 1078 1073 1067 1073 1073 1067 1073 1067 1067 1067 1067 16 3 0 0 0 3080 3081 0 0 15 1067 1079 1067 1079 1073 1067 1073 1067 1102 1103 1102 1070 1071 1072 1077 0 0 0 0 0
1067 1063 1064 1065 1066 1077 3080 3081 1078 1063 1064 1065 1066 1067 1063 1064 1065 1066 1067 1069 1070 1071 1072 1077 110 21 111 1078 1073 1069 1070 1071 1072 1069 1077 0 0 0 0 1078 1073 1069 1067 1069 1067 1069 1068 1069 1068 1077 0 97 0 0 0 3080 3081 0 99 0 1078 1070 1071 1072 1069 1068 1069 1068 1069 1068 1073 1080 1081 1082 1067 1089 1089 0 0 0
0 0 0 0 0 0 3080 3081 0 0 0 0 0 0 0 3080 3081 34 1078 1076 1080 1081 1082 1077 1101 16467 1101 1078 1067 1076 1080 1081 1082 1076 1073 1089 1089 1089 1089 1067 1067 1076 1067 1076 1067 1076 1079 1076 1079 1077 0 100 0 0 0 3080 3081 0 102 0 1078 1080 1081 1082 1076 1079 1076 1079 1076 1079 1067 1086 1087 1088 1067 1067 16 3 0 0
0 0 98 0 97 0 3080 3081 0 0 0 0 0 0 0 3080 3081 0 1078 1073 1086 1087 1088 1068 1102 1103 1102 1068 1073 1067 1086 1087 1088 1073 1067 1067 1069 1073 1069 1067 1070 1071 1072 1069 1073 1073 1073 1067 1073 1077 112 103 0 0 0 3080 3081 0 109 113 1078 1086 1087 1088 1073 1067 1073 1067 1067 1073 1067 1073 1073 1067 1077 0 0 0 0 0
25 0 101 0 100 0 3080 3081 0 0 0 0 0 0 0 3080 3081 0 1078 1067 1073 1069 1073 1079 1102 1103 1102 1079 1067 1068 1073 1067 1073 1067 1073 1073 1076 1067 1076 1073 1080 1081 1082 1076 1067 1067 1067 1073 1067 1073 1089 1089 1089 1089 1089 1089 1089 1089 1089 1089 1067 1073 1067 1073 1073 1073 1070 1071 1072 1067 1073 1070 1071 1072 1077 0 0 0 0 0
28 0 108 0 103 0 3080 3081 0 0 0 0 0 0 0 3080 3081 0 1078 1083 1084 1085 1067 1079 1068 1069 1073 1069 1073 1079 1069 1073 1069 1073 1067 1067 1073 1067 1073 1067 1086 1087 1088 1067 1073 1069 1073 1067 1073 1067 1067 1073 1067 1073 1067 1067 1073 1073 1067 1073 1067 1067 1073 1067 1073 1067 1080 1081 1082 1067 1073 1080 1081 1082 1077 0 0 0 0 0
1089 1089 1089 1089 1089 1089 1089 1089 1089 0 0 0 0 0 0 3080 3081 0 1078 1077 14 1078 1073 1067 1079 1076 1067 1076 1067 1068 1076 1067 1076 1067 1067 1073 1067 1073 1067 1073 1073 1067 1073 1073 1067 1076 1067 1073 1067 1073 1073 1067 1076 1067 1076 1073 1069 1073 1067 1073 1067 1067 1073 1067 1067 1069 1086 1087 1088 1076 1069 1086 1087 1088 1077 0 0 0 1089 1089
1068 1067 1068 1067 1068 1067 1068 1067 16 0 0 0 0 0 0 3080 3081 0 15 1077 17 1078 1067 1079 1079 1067 1073 1079 1067 1079 1067 1073 1067 1073 1073 1067 1064 1065 1066 1067 1063 1064 1065 1066 1073 1067 1073 1067 1076 1068 1069 1068 1068 1069 1068 1068 1069 1068 1073 1069 1073 1070 1071 1072 1076 1067 1063 1064 1067 1063 1064 1065 1066 1067 16 3 0 0 15 1067
1079 1068 1079 1068 1079 1068 1079 1077 0 0 0 0 0 0 0 3080 3081 0 0 18 17 19 3080 3081 15 1073 1067 1079 1073 1067 1073 1069 1073 1067 1077 16 0 0 0 0 0 0 0 0 15 1078 1067 1073 1067 1079 1076 1079 1079 1076 1079 1079 1076 1079 1067 1076 1067 1080 1081 1082 1077 16 0 0 0 0 0 0 0 0 0 0 0 0 0 0
1076 1079 1069 1079 1076 1079 1069 1077 0 0 0 0 0 0 0 3080 3081 0 0 20 21 22 3080 3081 0 1078 1073 1067 1067 1073 1067 1073 1067 1073 1077 0 0 0 0 0 99 0 0 97 0 1078 1070 1071 1072 1073 1067 1073 1069 1073 1073 1067 1076 1067 1073 1073 1073 1086 1087 1088 1077 0 0 0 0 0 0 0 0 0 0 0 0 0 0 0
1076 1067 1074 1076 1067 1067 1076 1077 0 0 0 0 0 0 0 3080 3081 0 0 18 17 19 3080 3081 0 1078 1070 1071 1072 1073 1067 1070 1071 1072 1077 0 0 104 105 0 109 0 0 103 33 1078 1080 1081 1082 1073 1073 1067 1073 1067 1073 1073 1067 1073 1067 1069 1067 1073 1073 1067 1077 0 0 0 0 0 0 0 0 0 0 0 0 0 0 0
1074 1075 1074 1075 1074 1075 1067 1077 0 0 0 0 0 0 0 3080 3081 0 0 18 21 19 3080 3081 0 1078 1080 1081 1082 1073 1073 1080 1081 1082 1077 0 0 4104 4105 1104 1105 1106 1104 1105 1106 1067 1086 1087 1088 1076 1067 1073 1067 1073 1073 1067 1073 1067 1073 1067 1073 1067 1076 1073 1077 0 0 0 0 0 0 0 0 0 0 0 1089 1089 1089 1089
1079 1067 1079 1067 1079 1067 1079 1077 0 0 0 0 0 0 0 3080 3081 0 0 20 17 22 3080 3081 0 1078 1086 1087 1088 1067 1067 1086 1087 1088 1077 0 0 3080 3081 1067 1067 1073 1067 1069 1073 1073 1069 1073 1067 1069 1073 1067 1069 1076 1067 1073 1073 1069 1073 1073 1067 1073 1069 1073 1077 0 0 0 0 0 0 0 0 0 0 0 15 1067 1073 1067
1069 1068 1076 1068 1069 1068 1067 16 0 0 0 0 0 0 0 0 0 0 0 18 21 19 3080 3081 0 15 1064 1065 1066 1067 1063 1064 1065 1066 16 0 0 3080 3081 34 1063 1064 1065 1066 1067 1073 1076 1073 1073 1073 1067 1073 1067 1073 1073 1067 1073 1067 1073 1067 1069 1067 1073 1073 1077 0 0 0 0 0 0 0 0 0 0 0 0 0 0 0
1074 1079 1074 1079 1074 1079 16 0 0 0 0 0 0 0 0 0 0 0 0 20 17 22 3080 3081 0 0 0 0 0 3080 3081 0 0 0 0 0 0 3080 3081 0 0 0 0 0 34 1069 1067 1073 1069 1067 1073 1069 1067 1067 1073 1073 1073 1067 1073 1067 1069 1067 1073 1073 1077 0 0 97 0 0 98 0 0 99 0 0 0 0 97 98
1076 1067 1076 1067 1076 16 0 0 0 0 0 0 0 0 0 0 0 0 0 18 21 19 3080 3081 0 0 0 0 0 3080 3081 0 0 0 0 0 0 3080 3081 0 0 0 0 0 0 1067 1070 1071 1072 1067 1067 1067 1073 1076 1067 1067 1067 1073 1067 1073 1067 1073 1067 1076 1077 0 0 100 0 0 101 0 0 102 0 0 0 0 100 101
1074 1075 1074 1075 16 0 0 0 0 0 0 0 0 0 0 0 0 0 0 18 17 19 3080 3081 0 0 0 0 0 3080 3081 0 0 0 0 0 0 3080 3081 0 0 0 0 0 0 1073 1080 1081 1082 1073 1069 1073 1073 1069 1073 1073 1073 1073 1069 1073 1073 1067 1073 1069 1077 0 0 103 0 0 108 0 0 109 0 104 105 0 103 108
1069 1068 1067 16 0 0 0 0 0 0 0 0 0 0 0 0 0 0 0 18 17 19 3080 3081 0 0 0 0 0 3080 3081 0 0 0 0 0 0 3080 3081 0 0 0 0 0 0 1069 1086 1087 1088 1067 1076 1067 1067 1076 1067 1067 1073 1073 1067 1073 1067 1073 1067 1073 1067 1089 1089 1089 1089 1089 1089 1089 1089 1089 1089 4104 4105 1089 1089 1089
1074 1079 16 0 0 0 0 0 0 0 0 0 0 0 0 0 0 0 0 20 21 22 0 0 0 0 0 0 0 3080 3081 0 0 0 0 0 0 3080 3081 0 0 0 0 0 0 1073 1067 1076 1067 1069 1073 1073 1069 1073 1073 1073 1079 1076 1079 1079 1069 1079 1079 1069 1076 1079 1069 1076 1079 1069 1076 1079 1069 1076 1077 3080 3081 15 1067 1069
1076 16 0 0 0 0 0 0 0 0 0 0 0 0 0 0 0 0 0 18 17 19 0 0 0 0 0 0 0 3080 3081 0 0 0 0 0 0 3080 3081 0 0 0 0 0 0 34 1065 1067 1063 1064 1065 1066 1067 1063 1064 1065 1066 1067 1063 1064 1065 1066 1067 1063 1064 1065 1066 1067 1063 1064 1065 1066 1078 1068 1077 3080 3081 0 0 0
1077 0 0 0 0 0 0 0 0 0 0 0 0 0 0 0 0 0 0 18 21 19 0 0 0 0 0 0 0 3080 3081 0 0 0 0 0 0 3080 3081 0 0 0 0 0 0 0 0 3080 3081 0 0 0 0 0 0 0 0 3080 3081 0 0 0 0 0 0 0 0 0 0 0 0 0 1078 1069 1077 3080 3081 0 0 0
1077 0 0 0 0 0 0 0 0 0 0 0 0 0 0 0 0 0 0 20 17 22 0 0 0 0 0 0 0 0 0 0 0 0 0 0 0 3080 3081 0 0 0 0 0 0 0 0 3080 3081 0 0 0 0 0 0 0 0 3080 3081 0 0 0 0 0 0 0 0 0 0 0 0 0 1078 1076 1077 3080 3081 0 97 98
1077 0 0 0 0 0 0 0 0 0 0 0 0 0 0 0 0 0 0 18 21 19 0 0 0 0 0 0 0 0 0 0 0 0 0 0 0 0 0 0 0 0 0 0 0 0 0 3080 3081 0 0 0 0 0 0 0 0 3080 3081 0 0 0 0 0 0 0 0 0 0 0 0 0 1078 1079 1077 3080 3081 0 100 101
1077 0 0 0 0 0 0 0 0 0 0 0 0 0 0 0 0 0 0 20 17 22 0 0 0 0 0 0 0 0 0 0 0 0 0 0 0 0 0 0 0 0 0 0 0 0 0 3080 3081 0 0 0 0 0 0 0 0 3080 3081 0 0 0 0 0 0 0 0 0 0 0 0 0 1078 1069 1077 3080 3081 0 103 108
1077 0 0 97 98 99 0 0 0 0 0 0 0 0 0 0 0 0 0 18 21 19 0 0 0 0 0 0 0 0 0 0 0 0 0 0 0 0 0 0 0 0 0 0 0 0 0 3080 3081 0 0 0 0 0 0 0 0 3080 3081 0 0 0 0 0 0 0 0 0 0 0 0 0 1078 1076 1077 3080 3081 1089 1089 1089
1077 0 0 100 101 102 0 0 0 0 0 0 0 0 0 0 0 0 0 18 17 19 0 0 0 0 0 0 0 0 0 0 0 0 0 0 0 0 0 0 0 0 0 0 0 0 0 3080 3081 0 0 0 0 0 0 0 0 3080 3081 0 0 0 0 0 0 0 0 0 0 0 0 0 1078 1069 1077 3080 3081 15 1069 1067
1077 104 105 103 108 109 0 0 0 0 0 0 0 0 0 0 0 0 0 20 21 22 0 0 0 0 0 0 0 0 0 0 0 0 0 0 0 0 0 0 0 0 0 0 0 0 0 0 0 0 0 0 0 0 0 0 0 3080 3081 0 0 0 0 0 0 0 0 0 0 0 0 0 1078 1076 1077 3080 3081 0 0 0
1077 4104 4105 1089 1089 1089 1089 0 0 0 0 0 0 0 0 0 0 0 0 18 17 19 0 0 0 0 0 0 0 0 0 0 0 0 0 0 0 0 0 0 0 0 0 0 0 0 0 0 0 0 0 0 0 0 0 0 0 3080 3081 0 0 0 0 0 0 0 0 0 0 0 0 0 15 1067 16 3080 3081 0 0 0
1077 3080 3081 1067 1069 1067 16 0 0 0 0 0 0 0 0 0 0 0 0 20 17 22 0 0 0 0 0 0 0 0 0 0 0 0 0 0 0 0 0 0 0 0 0 0 0 0 0 0 0 0 0 0 0 0 0 0 0 3080 3081 0 0 0 0 0 0 0 0 0 0 0 0 0 0 0 0 3080 3081 0 0 0
1077 3080 3081 0 0 0 0 0 0 0 0 0 0 0 0 0 0 0 0 18 21 19 0 0 0 0 0 0 0 0 0 0 0 0 0 0 0 0 0 0 0 0 0 0 0 0 0 0 0 0 0 0 0 0 0 0 0 0 0 0 0 0 0 0 0 0 0 0 0 0 0 0 0 0 0 3080 3081 0 0 0
1077 3080 3081 0 0 0 0 0 0 0 0 0 0 0 0 0 0 0 0 18 17 19 0 0 0 0 0 0 0 0 0 0 0 0 0 0 0 0 0 0 0 0 0 0 0 0 0 0 0 0 0 0 0 0 0 0 0 0 0 0 0 0 0 0 0 0 0 0 0 0 0 0 0 0 0 3080 3081 1089 1089 1089
1077 3080 3081 0 0 0 0 0 0 0 0 0 0 0 0 0 0 0 0 18 21 19 0 0 0 0 0 0 0 0 0 0 0 0 0 0 0 0 0 0 0 0 0 0 0 0 0 0 0 0 0 0 0 0 0 0 0 0 0 0 0 0 0 0 0 0 0 0 0 0 0 0 0 0 0 3080 3081 15 1069 1067
1067 1089 1089 1089 1089 1089 0 0 0 0 0 0 0 0 0 0 0 0 0 20 17 22 0 0 0 0 0 0 0 0 0 0 0 0 0 0 0 0 0 0 0 0 0 0 0 0 0 0 0 0 0 0 0 0 0 0 0 0 0 0 0 0 0 0 0 0 0 0 0 0 0 0 0 97 0 3080 3081 0 0 0
1069 1067 1067 1069 1067 16 0 0 0 0 0 0 0 0 0 0 0 0 0 18 21 19 0 0 0 0 0 0 0 0 0 0 0 0 0 0 0 0 0 0 0 0 0 0 0 0 0 0 0 0 0 0 0 0 0 0 0 0 0 0 0 0 0 0 0 0 0 0 0 0 0 0 0 100 0 3080 3081 0 114 115
1076 1079 1079 1069 1077 0 0 0 0 0 0 0 0 0 0 0 0 0 0 18 17 19 0 0 0 0 0 0 0 0 0 0 0 0 0 0 0 0 0 0 0 0 0 0 0 0 0 0 0 0 0 0 0 0 0 0 0 0 0 0 0 0 0 0 0 0 0 0 0 0 0 0 0 103 0 3080 3081 0 0 0
1079 1069 1079 1076 1077 20491 20491 20491 20491 20491 20491 20491 20491 20491 20491 20491 20491 35 35 36 37 38 35 20491 20491 20491 20491 20491 20491 20491 20491 20491 20491 20491 20491 20491 20491 20491 20491 20491 20491 20491 20491 20491 20491 20491 20491 20491 20491 20491 20491 20491 20491 20491 20491 20491 20491 20491 20491 20491 20491 20491 20491 20491 20491 20491 20491 20491 20491 20491 20491 20491 20491 1089 1089 1089 1089 1089 1089 1089
1073 1076 1079 1079 1079 1076 1069 1079 1076 1079 1069 1079 1076 1079 1069 1079 1077 16468 16469 16470 16471 16472 16473 1078 1076 1079 1079 1069 1076 1079 1073 1069 1079 1076 1069 1079 1079 1076 1069 1079 1079 1076 1069 1079 1073 1069 1076 1079 1079 1079 1073 1079 1073 1069 1076 1079 1079 1079 1079 1076 1079 1069 1079 1079 1076 1079 1069 1076 1069 1079 1079 1076 1073 1069 1079 1076 1069 1079 1076 1069
