66 48
0 0 0 0 0 0 1096 1097 1105 1106 1107 1106 1107 1106 1107 1106 1107 1106 1107 1108 1109 1097 1091 1092 1096 1110 1109 1097 1091 1092 1096 1110 1111 1112 1111 1112 1113 1097 3186 3187 1096 1110 1111 1112 1111 1112 1111 1112 1111 1112 1111 1112 1111 1112 1111 1112 1111 1112 1111 1112 1111 1112 1111 1112 1111 1112
0 0 0 0 0 0 1114 1115 1116 1117 1118 1117 1118 1117 1118 1117 1118 1117 1118 1119 1109 1115 3186 3187 1114 1113 1097 1115 3186 3187 1114 1095 1094 1095 1094 1111 1112 1115 3139 3140 1114 1111 1112 1115 0 160 0 160 0 160 0 0 0 0 1114 1095 1094 1095 1094 1115 1120 1121 1114 1095 1094 1095
0 0 0 0 0 0 1096 1097 1122 1117 1118 1117 1118 1117 1118 1117 1118 1117 1118 1123 1109 1097 3139 3140 1096 1110 1109 1097 3139 3140 1096 1112 1115 1120 1121 1114 1113 1097 3186 3187 1096 1110 1113 1097 0 160 0 161 0 160 0 0 0 0 1096 1110 1111 1112 1111 1097 1124 1125 1096 1112 1111 1112
0 0 0 0 0 0 1114 1115 1126 34 35 1058 1059 34 35 1058 35 34 35 1127 1109 1115 3186 3187 1114 1113 1097 1115 3186 3187 1114 1095 1097 1124 1125 1096 1112 1115 3139 3140 1114 1111 1112 1115 0 160 0 160 0 161 0 0 0 0 1114 1095 1094 1095 1094 1095 1094 1095 1094 1095 1094 1095
0 0 0 0 0 0 1114 1097 1128 36 37 1098 1129 38 39 1130 1098 36 37 1131 1109 1097 3139 3140 1096 1110 1109 1097 3139 3140 1096 1110 1111 1112 1111 1112 1113 1097 3186 3187 1096 1110 1113 1097 0 160 0 162 162 160 0 0 0 0 1096 1110 1111 1112 1111 1112 1111 1112 1111 1112 1111 1112
0 0 0 0 0 0 1096 1115 1132 40 41 1098 1133 42 43 1134 1098 40 44 1135 1109 1115 45 46 1114 1113 1097 1115 45 46 1114 1095 1094 1095 1094 1111 1112 1115 3139 3140 1114 1111 1112 1115 0 161 163 164 165 166 0 0 0 0 12333 46 47 48 47 48 47 48 47 49 50 1114
0 0 0 0 0 0 1114 1097 1128 51 52 1098 1136 53 54 1137 1098 51 55 1131 1109 1097 56 57 1096 1110 1109 1097 56 57 1096 1110 1111 1112 1111 1112 1113 1097 1138 1139 1096 1110 1113 1097 0 167 168 169 170 171 162 0 0 0 12344 57 58 59 58 59 58 59 58 60 61 1096
0 0 0 0 0 0 0 0 0 62 63 0 0 64 65 0 0 62 63 0 0 0 0 0 0 0 0 0 0 0 0 0 66 1140 1141 1142 1143 1144 67 68 1114 1111 1112 1115 1025 1025 1025 1025 1025 1025 1025 1025 1025 1025 1145 1145 1145 1145 1145 1145 1145 1145 1145 4163 4164 1114
0 0 0 0 0 0 0 0 0 0 0 0 0 0 0 0 0 0 0 0 0 0 0 0 0 0 0 0 0 0 0 0 172 172 172 172 1146 1147 38 39 1148 1114 1095 1112 1145 1145 1145 1145 1145 1145 1145 1145 1145 1145 1111 1112 1115 1120 1121 1114 1111 1112 1115 3186 3187 1096
0 0 0 0 0 0 0 0 0 0 0 0 0 0 0 0 0 0 0 0 0 0 0 0 0 0 0 0 0 0 0 0 0 0 66 1140 1097 1149 42 43 1150 1096 1094 1095 1094 1095 1094 1095 1094 1095 1094 1095 1094 1095 1094 1095 1097 1124 1125 1096 1094 1095 1097 3139 3140 1114
1025 1025 1025 1025 1025 1025 49306 0 0 0 0 0 0 0 0 0 0 0 0 0 0 50331 1025 1025 1025 1025 1025 1025 1025 1025 49306 0 0 0 0 69 1115 1136 53 54 1137 1114 1095 1112 1111 1112 1111 1112 1111 1112 1111 1112 1111 1112 1111 1112 1111 1112 1111 1112 1111 1112 1115 3186 3187 1096
1145 1145 1145 1145 1145 1145 1151 1025 1025 1025 1025 1025 1025 1025 1025 1025 1025 1025 1025 1025 1025 1152 1145 1145 1145 1145 1145 1145 1145 1145 1151 49306 0 0 0 0 0 0 64 65 0 0 0 160 0 160 1114 1115 0 160 0 0 0 0 0 0 160 0 0 0 1114 1095 1097 3139 3140 1114
1095 1094 1095 1094 1095 1094 1145 1145 1145 1145 1145 1145 1145 1145 1145 1145 1145 1145 1145 1145 1145 1145 1095 1094 1095 1094 1095 1094 1095 1094 1145 1151 49306 0 0 0 0 0 0 0 0 0 0 161 167 160 1096 1097 173 174 175 176 175 175 175 175 174 175 175 176 1096 1110 1115 3186 3187 1096
1112 1111 1112 1111 1112 1111 1112 1111 1153 1154 1153 1154 1153 1154 1153 1154 1112 1111 1112 1111 1112 1111 1112 1115 1120 1121 1114 1113 1112 1111 1112 1145 1151 49306 0 0 0 0 0 0 0 0 0 160 177 178 1114 1115 0 160 0 0 0 0 0 0 160 0 0 0 45 46 48 3121 3122 1114
1095 1094 1095 1094 1095 1094 1095 1094 1095 1094 1095 1094 1095 1094 1095 1094 1095 1094 1095 1094 1095 1094 1095 1097 1124 1125 1096 1112 1095 1094 1095 1094 1145 1151 51356 52381 0 0 0 0 0 31 32 160 179 180 1096 1097 0 160 0 0 0 0 0 0 160 0 0 0 56 57 59 3132 3133 1096
0 181 182 0 1114 1095 1112 1115 1120 1121 1096 1111 1112 1111 1112 1111 1112 1111 1112 1111 1112 1111 1112 1111 1112 1111 1112 1111 1112 1111 1112 1111 1112 1145 1155 1156 1025 1025 1025 1025 1025 4127 4128 1025 1025 1025 1114 1115 0 160 0 0 0 0 0 167 160 0 0 0 1145 1145 1145 1145 1145 1095
175 183 184 0 1096 1110 1095 1097 1124 1125 1114 1094 1095 1094 1095 1094 1095 1094 1095 1094 1095 1094 1095 1094 1095 1094 1095 1094 1095 1094 1095 1094 1095 1094 1145 1145 1145 1145 1145 1145 1145 3103 3104 1145 1145 1145 1096 1097 0 160 0 0 0 0 163 164 160 0 0 0 1096 1110 1111 1112 1111 1112
0 0 0 0 1114 1095 1112 1111 1112 1111 1112 1111 1112 1113 1097 0 0 185 186 0 0 181 182 0 0 0 1114 1095 1112 1111 1112 1111 1112 1111 1112 1095 1094 1095 1094 1113 1097 3103 3104 160 0 160 1114 1115 0 160 0 0 0 167 168 169 161 0 0 0 1114 1095 1094 1095 1094 1095
0 187 0 0 12333 46 48 49 50 1094 1095 1094 1095 1094 1115 0 0 188 173 175 175 183 184 0 0 0 1096 1110 1095 1094 1095 1094 1095 1094 1095 1094 1095 1094 1095 1094 1115 3103 3104 160 0 160 1096 1097 0 161 0 0 1025 1025 1025 1025 1025 1025 1025 1025 1096 1110 1111 1110 1111 1112
0 174 0 0 12344 57 59 60 61 1111 1112 1111 1112 1113 1097 162 0 0 0 0 0 0 0 0 0 0 1114 1111 1112 1111 1112 1115 0 0 0 0 0 1111 1112 1113 1097 3103 3104 160 0 160 1114 1115 0 160 0 0 0 0 1145 1145 1145 1145 1145 1145 1094 1115 1120 1121 1114 1095
1025 1025 1025 1025 1145 1145 1145 4145 4146 48 47 48 47 45 12334 165 166 0 0 0 0 0 0 0 0 0 1096 1094 1095 1094 1095 1097 0 0 0 0 0 1114 1095 1094 1115 3103 3104 160 0 161 1096 1097 0 160 0 0 0 0 1096 1110 1111 1112 1111 1112 1111 1097 1124 1125 1096 1112
1145 1145 1145 1145 1112 1113 1097 3132 3133 59 58 59 58 56 12345 170 171 162 0 0 0 0 0 0 0 0 1114 1111 1112 1111 1112 1115 0 0 0 31 32 1096 1110 1113 1097 3103 3104 161 0 160 1114 1115 1025 1025 0 0 0 0 1114 1095 1094 1095 70 71 1094 1095 1094 1095 1094 1095
1111 1112 1111 1112 1095 1094 1115 4163 4249 1145 1145 1145 1145 1145 1145 1025 1025 1025 1025 1025 1025 1025 1025 1025 32801 32801 1096 1094 1095 1094 1095 1097 1025 1025 1025 4127 4128 1114 1095 1094 1115 3103 3104 160 0 160 1096 1097 0 174 175 175 175 176 1096 1097 1099 1157 38 39 1158 1100 1096 1094 1095 1112
1112 1111 1112 1111 1112 1111 1097 3186 3224 1096 1110 1095 1110 1095 1110 1145 1145 1145 1145 1145 1145 1145 1145 1145 32801 32801 1114 1111 1112 1111 1112 1115 1145 1145 1145 3103 3104 1096 1110 1113 1097 3103 3104 160 0 160 0 0 0 160 0 0 0 0 1114 1115 1159 1160 42 43 1161 1162 1114 1111 1112 1095
1111 1112 1111 1112 1111 1112 1115 3139 3225 1114 1111 1112 1095 1112 1095 1110 1111 1112 1111 1112 1111 1112 1095 1097 4127 4128 0 0 0 0 0 0 0 0 0 3103 3104 1114 1095 1094 1115 3103 3104 160 0 161 0 0 0 160 0 10240 0 0 72 73 74 1136 53 54 1137 1098 1096 1094 1095 1112
1112 1115 1120 1121 1114 1111 1097 3186 3224 1096 1110 1095 1110 1095 1112 1095 1110 1111 1112 1095 1112 1111 1112 1115 3103 3104 0 0 0 0 0 0 0 0 0 3103 3104 1096 1110 1113 1097 3103 3104 161 0 160 0 0 0 160 0 0 0 0 0 0 0 0 64 65 0 0 0 0 1114 1095
1095 1097 1124 1125 1096 1094 1115 3139 3225 1114 1111 1112 1095 1112 1095 1110 1095 1094 1095 1110 1095 1094 1095 1097 3103 3104 0 0 0 0 0 0 0 0 0 3103 3104 1114 1095 1094 1115 3103 3104 160 167 160 0 0 0 161 0 0 0 0 0 0 187 0 0 0 167 0 0 0 1096 1110
1112 1111 1112 1111 1112 1113 1097 3186 3224 1096 1110 1111 1112 1111 1112 1095 1110 1111 1112 1095 1112 1111 1112 1115 3103 3104 0 0 0 0 0 0 0 0 0 3103 3104 1096 1110 1113 1097 3103 3104 160 163 164 0 0 0 160 0 0 0 0 0 0 174 0 0 0 177 178 0 0 1114 1095
1111 1112 1111 1112 1095 1094 1115 3139 3225 1114 1095 1112 1095 1112 1111 1112 1095 1094 1095 1110 1095 1094 1095 1110 1025 1025 1025 1025 1025 1025 1025 1025 1025 1025 1025 1025 1025 1114 1095 1094 1115 3103 3104 160 168 169 0 0 0 160 0 0 0 0 0 0 161 0 0 0 179 180 31 32 1096 1110
1112 1111 1112 1111 1112 1113 1097 3186 3224 1096 1110 1111 1112 1111 1112 1111 1112 1095 1112 1095 1112 1095 1112 1095 1145 1145 1145 1145 1145 1145 1145 1145 1145 1145 1145 1145 1145 1111 1112 1113 1097 1025 1025 1025 1025 1025 1025 1025 1025 1025 1025 1025 1025 1025 1025 1025 1025 1025 1025 1025 1025 1025 4127 4128 1114 1095
1111 1112 1111 1112 1095 1094 1115 3139 3225 1114 1095 1112 1111 1112 1111 1112 1111 1112 1111 1112 1111 1112 1111 1112 1111 1112 1111 1112 1111 1112 1111 1094 1095 1094 1115 1120 1121 1114 1095 1094 1145 1145 1145 1145 1145 1145 1145 1145 1145 1145 1145 1145 1145 1145 1145 1145 1145 1145 1145 1145 1145 1145 3103 3104 1096 1110
1112 1111 1112 1111 1112 1113 1097 3186 3224 1096 1110 1111 1112 1115 0 0 0 0 0 0 0 0 0 0 0 1096 1110 1112 1111 1112 1111 1111 1112 1111 1097 1124 1125 1096 1112 1111 1112 1111 1112 1111 1112 1111 1112 1111 1112 1111 1112 1111 1112 1111 1112 1111 1112 1111 1112 1111 1112 1115 3103 3104 1114 1095
1111 1112 1111 1112 1095 1094 1115 3139 3225 1114 1095 1112 1113 1097 0 0 0 0 0 0 0 0 0 0 0 1114 1095 1095 1094 1095 1094 1094 1095 1094 1095 1094 1095 1094 1095 1094 1095 1094 1095 1094 1115 49 50 48 47 48 47 48 47 48 47 48 47 48 47 48 45 46 3103 3104 1096 1110
1112 1111 1112 1111 1112 1113 1097 3186 3224 1096 1110 1111 1112 1115 0 0 0 162 0 0 0 0 0 0 0 1096 1110 1112 1111 1112 1111 1111 1112 1111 1112 1111 1112 1111 1112 1111 1112 1111 1112 1113 1097 60 61 59 58 59 58 59 58 59 58 59 58 59 58 59 56 57 3103 3104 1114 1095
1111 1112 1111 1112 1095 1094 1115 3121 3122 48 47 48 45 12334 0 0 0 165 166 0 0 0 0 0 0 12333 46 48 47 48 47 49 50 48 47 48 47 48 47 48 47 48 47 48 47 4145 4146 1145 1145 1145 1145 1145 1145 1145 1145 1145 1145 1145 1145 1145 1145 1145 3103 3104 1096 1110
1112 1111 1112 1111 1112 1113 1097 3132 3133 59 58 59 56 12345 0 0 0 170 171 162 0 0 0 0 0 12344 57 59 58 59 58 60 61 59 58 59 58 59 58 59 58 59 58 59 58 3132 3133 1096 1094 1095 1094 1095 1094 1095 1094 1095 1094 1095 1094 1095 1094 1115 3103 3104 1114 1095
1111 1112 1111 1112 1111 1112 1111 1145 1145 1145 1145 1145 1145 1145 1025 1025 1025 1025 1025 1025 1025 1025 1025 1025 1025 1145 1145 1145 1145 1145 1145 1145 1145 1145 1145 1145 1145 1145 1145 1145 1145 1145 1145 1145 1145 1145 1145 1112 1111 1112 1111 1112 1111 1112 1111 1112 1111 1112 1111 1112 1111 1097 3103 3104 1096 1110
1112 1115 1120 1121 1114 1111 1112 1111 1112 1111 1112 1111 1112 1111 1145 1145 1145 1145 1145 1145 1145 1145 1145 1145 1145 1111 1112 1111 1112 1111 1112 1111 1112 1113 1097 1099 1100 75 1100 1099 1100 75 1100 1099 1100 1099 1100 75 1100 1099 1100 75 1100 1099 1100 75 76 1099 1100 1096 1094 1115 3103 3104 1114 1095
1111 1097 1124 1125 1096 1112 1111 1112 1111 1112 1111 1112 1111 1112 1111 1112 1111 1112 1111 1112 1111 1112 1111 1112 1111 1112 1111 1112 1111 1112 1111 1112 1095 1094 1115 1163 1164 77 1165 1163 1164 77 1165 1163 1166 1163 1164 77 1165 1163 1164 77 1165 1163 1164 38 39 1167 1166 1114 1095 1097 3103 3104 1096 1110
1112 1111 1112 1111 1112 1111 1112 1111 1112 1111 1112 1111 1112 1111 1112 1111 1112 1111 1112 1111 1112 1111 1112 1111 1112 1111 1112 1111 1112 1111 1112 1111 1112 1113 1097 1159 1160 78 1150 1159 1160 78 1150 1159 1162 1159 1160 78 1150 1159 1160 78 1150 1159 1160 42 43 1161 1162 1096 1094 1115 3103 3104 1114 1095
1111 1112 1111 1112 1111 1112 1111 1112 1111 1112 1111 1112 1111 1112 1111 1112 1111 1112 1111 1112 1111 1112 1111 1112 1111 1112 1111 1112 1111 1112 1111 1112 1095 1094 1115 1098 1136 79 1137 1098 1136 79 1137 1098 1098 1098 1136 79 1137 1098 1136 79 1137 1098 1136 53 54 1137 1098 1114 1095 1097 3103 3104 1096 1110
1112 1111 1112 1111 1112 1111 1112 1111 1112 1111 1112 1111 1112 1115 1120 1121 1114 1111 1112 1115 0 0 0 0 0 0 0 0 0 160 181 182 185 186 0 0 0 80 0 0 0 80 0 0 0 0 0 80 0 0 0 80 0 0 0 64 65 0 0 0 0 0 3103 3104 1114 1095
1111 1112 1111 1112 1111 1112 1111 1112 1111 1112 1111 1112 1111 1097 1124 1125 1096 1112 1113 1097 176 175 175 175 175 175 175 175 175 174 183 184 188 173 175 175 176 175 175 175 175 174 0 0 0 0 0 0 0 0 0 0 0 0 0 0 0 0 0 0 0 0 3103 3104 1096 1110
1112 1111 1112 1111 1112 1111 1112 1111 1112 1111 1112 1111 1112 1111 1112 1111 1112 1111 1112 1115 189 190 0 0 0 0 0 0 0 161 0 0 0 0 0 0 0 0 0 0 0 160 0 0 0 0 0 0 0 0 0 0 0 0 0 0 0 0 0 0 0 0 3103 3104 1114 1095
1111 1112 1111 1112 1111 1112 1111 1112 1111 1112 1111 1112 1111 1112 1111 1112 1111 1112 1113 1097 0 0 0 0 0 0 0 0 0 160 0 0 0 0 0 0 0 0 0 0 0 161 0 0 0 0 0 0 0 0 0 0 0 0 0 0 0 0 0 0 0 167 3103 3104 1096 1110
1112 1111 1112 1111 1112 1111 1112 1111 1112 1111 1112 1111 1112 1111 1112 1111 1112 1111 1112 1115 1025 1025 1025 1025 51356 52381 0 0 0 160 0 0 0 54431 53406 1025 1168 1169 1169 1169 1169 1169 1169 1170 1025 1025 1171 1172 1172 1172 1172 1172 1172 1173 1025 1025 1025 1025 1025 1025 1025 1025 1025 1025 1114 1095
1111 1112 1111 1112 1111 1112 1111 1112 1111 1112 1111 1112 1111 1112 1111 1112 1111 1112 1111 1112 1145 1145 1145 1145 1155 1156 49306 0 0 160 0 54431 53406 1174 1175 1145 1145 1145 1145 1145 1145 1145 1145 1145 1145 1145 1145 1145 1145 1145 1145 1145 1145 1145 1145 1145 1145 1145 1145 1145 1145 1145 1145 1145 1095 1112
1112 1111 1112 1111 1112 1111 1112 1111 1112 1111 1112 1111 1112 1111 1112 1111 1112 1111 1112 1111 1112 1111 1112 1111 1145 1145 1151 1025 1025 1025 1025 1174 1175 1145 1145 1111 1112 1111 1112 1111 1112 1111 1112 1111 1112 1111 1112 1111 1112 1111 1112 1111 1112 1111 1112 1111 1112 1111 1112 1111 1112 1111 1112 1111 1112 1095
