66 48
1026 1026 1026 1026 1026 1026 1026 1026 1026 1026 1026 1026 1026 1026 1026 1026 1089 143 144 145 146 144 145 146 145 146 144 145 146 144 145 146 144 145 146 145 55 143 145 145 146 145 146 1080 1103 1104 1104 1104 1104 1104 1104 1104 1104 1104 1104 1104 1104 1104 1104 1105 1080 143 145 145 144 145
143 145 144 145 145 145 145 144 145 145 145 144 145 145 145 145 56 147 148 149 149 148 150 149 149 149 148 150 149 148 149 149 148 150 149 148 55 147 148 150 149 149 149 1079 1106 1107 1087 1107 1087 1087 1087 1107 1087 1107 1087 1107 1087 1107 1087 1087 1079 147 150 151 148 152
153 148 148 150 150 149 148 148 150 150 149 148 150 150 149 152 55 154 148 150 150 148 155 150 150 150 148 155 150 148 150 150 148 155 150 151 55 154 151 155 150 150 150 1079 1108 1081 1082 1082 1082 1082 1100 1100 1081 1081 1100 1081 1081 1082 1081 1082 1079 154 151 0 151 148
154 151 148 155 151 148 151 148 155 151 148 148 155 151 148 148 55 147 148 155 150 148 150 150 155 150 148 150 150 148 155 150 148 150 150 156 55 147 156 150 150 155 150 1079 1108 1081 1082 1109 1082 1082 1100 1100 1081 1081 1100 1081 1081 1110 1081 1082 1079 157 0 0 0 149
147 158 148 150 159 149 158 148 150 159 149 148 150 159 149 150 55 154 151 150 149 148 148 149 150 149 148 148 149 151 150 149 148 148 149 148 55 154 148 148 155 150 149 1089 1111 1026 1026 1026 1026 1026 1026 1026 1026 1026 1026 1026 1026 1026 1026 1026 1089 153 0 0 0 150
157 156 148 148 150 149 156 148 148 48 149 148 148 150 149 160 55 153 161 150 150 149 149 150 150 150 149 149 150 161 150 150 149 149 150 149 55 153 149 149 150 150 150 1080 0 0 0 1055 1056 1056 1056 1056 1056 1056 1056 1056 1057 162 0 0 1080 153 156 0 0 150
147 149 149 149 155 148 149 149 149 163 148 149 149 155 148 149 55 147 156 150 150 148 148 150 150 150 148 148 150 156 150 150 148 148 150 150 55 147 150 148 150 150 150 1079 10240 10240 0 1058 1059 1059 1059 1059 1059 1059 1059 1059 1060 164 0 0 1089 1111 1026 4098 4098 1026
154 148 148 148 150 149 155 148 148 163 149 155 148 150 149 155 55 154 148 149 149 149 149 151 149 149 149 149 151 148 149 149 149 149 151 150 55 154 150 149 151 149 149 1079 0 0 0 0 165 0 165 0 165 0 166 167 0 0 0 0 12344 143 144 3111 3112 144
1026 1026 1026 1026 1026 1089 1111 1026 1026 1026 1026 1026 1026 1026 1026 1026 1089 1111 1026 1026 1026 1026 1026 1026 1026 1026 1026 1026 1026 1026 1026 1026 1026 1026 1026 1026 1089 1111 1026 4098 4098 1026 1026 1089 0 0 0 0 1061 0 1061 0 1061 0 168 169 170 170 170 161 12343 147 151 3113 3114 155
1099 1099 1099 1099 1099 1080 49 50 0 0 0 0 0 0 0 12288 0 0 145 0 0 0 0 145 0 0 0 0 0 144 0 48 49 50 0 145 0 0 0 3111 3112 0 0 0 12288 0 0 0 1062 0 1062 0 1062 0 166 167 0 0 0 0 12343 147 0 3115 3116 150
1109 1088 1109 1088 1109 1079 49 50 0 0 0 0 0 0 0 12288 0 0 171 0 0 0 0 148 0 0 0 0 0 172 0 173 49 50 0 148 0 0 0 3115 3116 0 0 0 12288 0 0 0 0 0 0 0 0 0 12335 174 0 0 0 0 12343 157 0 3115 3116 150
1112 1100 1113 1114 161 1079 49 50 0 0 0 0 0 0 0 12288 0 0 0 0 0 0 0 171 0 0 0 0 0 0 0 159 49 50 0 171 0 0 0 3115 3116 0 0 0 12288 0 0 0 0 0 0 0 0 0 12335 174 0 0 0 0 1089 1111 1026 1026 1026 1026
1082 1081 1115 1116 175 1079 49 50 0 0 0 0 0 0 0 12288 12288 12288 12288 12288 12288 12288 12288 12288 12288 12288 12288 12288 12288 12288 12288 12336 12337 12338 12288 12288 12288 12339 12288 3115 3116 12288 12288 12288 12288 0 0 0 0 0 0 0 0 0 12335 174 0 0 0 0 1080 1106 1087 1087 1099 1087
1082 1081 1103 1105 1117 1079 49 50 1089 1111 1026 1026 1026 1089 0 12288 0 0 0 0 0 0 0 0 0 0 0 0 0 176 177 163 49 50 0 0 176 177 12288 3115 3116 12288 50315 1118 0 0 0 1119 1120 1120 1120 1120 1120 1120 1121 1089 1111 1026 1026 1026 1089 1108 1113 1122 1114 1123
1082 1081 1087 1089 1089 1089 49 50 1089 1089 1089 1089 1089 0 0 0 1089 1089 49290 0 0 0 0 0 0 0 0 0 0 178 179 173 49 50 0 51 178 179 12288 3117 3118 50315 1124 1080 0 0 0 1089 1111 1026 1026 1026 1026 1026 1026 1089 1099 1099 1099 1099 1080 1108 1115 1125 1116 1126
1026 1026 1026 1089 1127 0 49 50 0 1128 1089 1089 0 0 0 0 1080 1129 1130 1089 0 0 0 0 0 0 0 0 1089 1111 1026 1089 49 50 1089 1111 1026 1026 1026 1026 1118 1124 1131 1079 0 0 0 1080 1087 1087 1099 1087 1099 1087 1087 1099 1082 1082 1109 1088 1079 1108 1103 1104 1105 1117
0 0 0 1089 1089 1089 49 50 1089 1089 1089 0 0 0 0 180 1079 1108 1132 1080 0 0 0 0 0 0 0 0 1080 1106 1107 1080 49 50 1080 1106 1087 1087 1099 1087 1080 1126 1082 1079 0 0 0 1079 1100 1082 1100 1088 1110 1100 1082 1100 1110 1100 1112 1088 1079 1123 1087 1087 1087 1133
0 0 0 0 0 0 49 50 0 0 0 0 0 0 180 20532 1089 1108 1088 1079 0 0 0 0 0 0 0 0 1079 1108 1088 1079 49 50 1079 1108 1113 1122 1114 1123 1079 1117 1110 1079 20533 20533 20533 1089 1111 1026 1026 1026 1026 1026 1026 1026 1026 1026 1026 1026 1089 1111 1026 1026 1026 1026
0 181 182 181 183 184 49 50 0 0 0 0 0 180 20532 20580 1099 1133 1081 1079 20533 20533 20533 20533 20533 20533 20533 20533 1079 1108 1081 1079 49 50 1079 1108 1115 1125 1116 1126 1079 1117 1100 1089 1111 1026 1026 1089 48 1087 1087 1099 1087 1099 1099 1099 1099 0 1099 1087 1107 1087 1107 1087 1087 1087
0 185 186 187 188 189 49 50 0 0 0 0 180 20532 20580 1131 1081 1109 1088 1089 1111 1026 1026 1026 1026 1026 1026 1026 1089 1108 1088 1079 49 50 1079 1108 1103 1104 1105 1117 1079 1117 1082 1100 1082 1109 1109 1100 159 1088 1100 1082 1088 1082 1082 1109 1088 159 1110 1088 1082 1088 1082 1088 1082 1088
0 190 191 192 0 0 49 50 0 0 0 180 20532 20580 1131 1088 1082 1112 1109 1099 1099 1107 1099 1134 1099 1087 1099 1107 1087 1133 1081 1079 49 50 1079 1123 1087 1087 1087 1133 1079 1117 1082 1082 1081 1112 1088 1110 48 1100 1082 1100 1088 1110 1100 1112 1088 193 1082 1088 1100 1100 1100 1100 1081 1100
1089 1111 1026 1026 1026 1089 49 50 1089 1089 180 20532 20580 1131 1109 57 1081 58 1112 1081 1082 1100 1081 1109 1081 1081 1082 1100 1081 1109 1081 1079 49 50 1079 1108 1082 1100 1081 1109 1079 1117 1082 1082 1100 1081 1109 1126 163 1109 1081 1100 1109 1082 1109 1089 1111 1026 1026 1026 1026 1026 1089 1117 1082 1109
1089 1111 1026 1026 1089 1089 21558 21558 1089 1080 20532 20580 1131 57 1112 1109 1082 1081 58 1088 1110 1082 1100 1112 1088 1088 1110 1082 1100 1112 1088 1079 49 50 1079 1108 1110 1082 1100 1112 1079 1117 1082 1110 1082 1100 1112 1126 163 1112 1081 1100 1112 1100 1112 1080 0 48 0 145 0 0 1080 1123 1081 1112
1080 0 163 1081 1080 1089 1111 1026 1089 1089 1124 1131 1088 57 1109 1112 1082 1088 1089 1111 1026 1026 1026 1026 1026 1026 1026 1026 1026 1026 1026 1089 49 50 1089 1111 1026 1026 1026 1026 1118 1111 1026 1026 1026 1026 1089 1117 163 1100 1100 1100 1100 1100 59 12348 0 163 0 171 0 0 12347 60 1117 1100
1079 0 163 1109 1079 1108 1110 57 57 1099 1131 1100 1081 1109 1112 58 1088 1088 1080 194 195 196 183 194 195 196 183 194 195 196 183 184 49 50 0 0 0 194 195 196 0 0 0 0 0 0 1080 1108 163 1100 1082 1110 1082 1100 61 12350 0 173 0 0 0 0 12349 62 1108 1082
1079 0 163 0 1079 1108 1081 1109 57 1082 57 57 57 1109 57 58 58 1109 1079 197 198 199 188 197 200 199 188 197 201 199 188 189 49 50 0 0 0 197 202 199 0 0 0 0 203 204 1079 1123 163 1082 1081 1082 1109 1082 4232 4233 1089 1111 1026 1026 1026 1089 4232 4233 1123 1081
1079 0 163 0 1089 1123 1082 1112 57 1081 57 1109 57 1112 1109 1109 1109 0 1079 205 206 207 0 205 206 207 0 205 206 207 0 0 49 50 0 0 0 205 206 207 0 0 0 0 0 0 1079 1117 173 1109 1081 1109 1112 1100 3206 3207 1106 1087 1099 1134 1099 1099 3206 3207 1126 1081
1079 0 163 0 59 60 1108 57 1109 1082 1109 1112 1109 1082 1112 1112 1112 0 1089 1111 1026 1026 1026 1026 1026 1026 1026 1026 1026 1026 1026 1089 49 50 1089 1111 1026 1026 1026 1026 1026 1026 1026 1026 1026 1026 1089 1117 159 208 1082 159 1100 1100 3208 3209 1126 1100 1081 1082 1081 1081 3208 3209 1126 1088
1079 0 163 0 61 62 1108 57 0 1081 1112 1088 1112 1082 1100 1081 1081 1112 63 1087 1099 1099 1087 1099 1099 1087 1099 1087 1087 1087 1099 1080 49 50 1080 1106 1134 1087 1087 1087 1087 1087 1087 1087 1087 1087 1087 1133 0 1112 1100 48 1082 1100 3206 3207 1117 1100 1110 1081 1109 1081 3206 3207 1123 1088
1089 1111 1026 1089 4232 4233 1108 57 1100 1109 1081 1081 1081 1081 1100 1110 58 1081 57 1081 1081 1081 1100 1109 1088 1109 1082 1109 1100 1100 1109 1079 49 50 1079 1108 1082 1109 1100 1082 1109 1089 1111 1026 1026 1026 1026 1026 1089 1126 1100 163 1081 1082 3208 3209 1108 171 1081 1081 1135 1109 3208 3209 1126 1100
1106 1099 163 1099 3206 3207 1123 64 1100 1112 1082 64 1100 1081 1100 1081 1082 1081 1109 1102 1081 57 1109 1112 1081 1112 57 1112 1082 1109 1112 1079 49 50 65 66 1082 1112 1082 1082 1112 1080 173 0 0 0 0 0 1080 1126 1100 1136 1081 1082 3206 3207 1126 163 1082 1100 1082 0 3206 3207 1117 1081
209 57 163 1109 3208 3209 1108 57 1082 1100 1081 57 1082 1082 1100 1100 58 58 1112 1100 58 58 1112 1088 1109 1081 57 1081 1081 1112 57 1079 49 50 59 60 67 68 67 68 59 12348 159 0 0 0 176 177 12347 60 67 68 67 68 3131 3132 1117 163 1081 171 1081 1135 3208 3209 1126 1081
175 1109 173 1137 3206 3207 1108 64 1110 1082 1100 64 1110 1081 1082 1082 1088 1082 1102 1102 1088 57 1082 1081 1112 1081 58 1081 1082 1082 57 1079 49 50 61 62 69 70 69 70 61 12350 48 210 0 51 178 179 12349 62 69 70 69 70 3133 3134 1108 163 1100 1135 1100 1088 3206 3207 1117 1100
1089 1111 1026 1089 3208 3209 1138 1139 1140 1026 1026 2 2 1026 1026 1026 1026 1026 1026 1026 1026 2 1026 1026 1026 1026 2 1026 1026 1026 1026 1089 49 50 1089 1106 1099 1087 1099 1099 1099 1089 1111 1026 1026 1026 1026 1026 1089 1106 1087 1141 1134 1099 1087 1099 1133 173 1088 1088 1082 1081 3208 3209 1108 1082
1080 1106 1099 1107 3206 3207 1142 1143 211 48 0 71 0 0 0 0 212 212 213 212 212 71 0 0 145 0 71 0 0 0 48 0 49 50 1080 1126 1100 1100 1081 1081 1082 1087 1099 1087 1087 1099 1087 1087 1087 1133 1110 163 1082 1100 1100 1082 1100 1135 171 1100 1081 1100 3206 3207 1123 1081
1079 1126 1100 1081 3208 3209 1126 1079 0 173 0 0 0 0 0 0 0 0 213 0 0 0 0 0 171 0 0 0 0 0 173 0 49 50 1079 1117 1109 1100 1110 1109 1100 1100 1081 1081 1081 1081 1081 1082 1100 1081 1081 163 1082 1110 1109 1109 1100 1100 1135 171 1081 1082 3208 3209 1126 1081
1079 1113 1114 1117 3206 3207 1126 1079 0 159 214 0 0 0 0 0 0 0 215 0 0 0 0 0 0 0 0 0 0 0 159 0 49 50 1079 1108 158 1100 1081 159 1082 1100 1110 1081 1081 1110 1081 1100 1100 1110 1081 1144 1100 1082 1145 1146 1100 1082 1088 1147 1081 1082 3206 3207 1126 1109
1079 1115 1116 1108 3208 3209 1126 1079 0 48 149 0 0 0 72 0 0 0 216 0 0 0 0 73 74 0 0 0 0 0 48 0 49 50 1079 1123 1112 1100 1100 48 1082 1100 1081 1082 59 60 67 68 67 68 67 68 67 68 67 68 67 68 67 68 67 68 3131 3132 1126 1112
1079 1115 1116 1108 3206 3207 1108 1089 1111 1026 1026 1026 1026 1026 5122 1089 49290 0 0 0 50316 1089 1111 5122 5122 1026 1089 51341 52366 0 163 0 49 50 1079 1126 1081 1082 1082 163 1100 1082 1100 1081 61 62 69 70 69 70 69 70 69 70 69 70 69 70 69 70 69 70 3133 3134 1117 1081
1079 1115 1116 1123 3208 3209 1126 1107 1099 1099 1099 1087 48 1099 63 1080 1148 49290 0 50316 1149 1087 1107 75 63 1087 1087 1150 1151 49290 173 0 49 50 1079 1117 1110 1100 1100 163 1082 1110 1082 1100 4232 4233 1106 1134 1099 1087 1107 1141 1107 1087 1099 1087 1099 1134 1087 1099 1134 1087 1099 1099 1133 1081
1079 1115 1116 1117 3206 3207 1108 1082 1082 1109 1109 1088 163 1100 76 1079 1152 1130 1026 1149 1131 1100 1081 57 57 1081 1109 1153 1154 1130 1026 1089 49 50 1079 1126 1081 1082 1082 163 1100 1081 1081 1082 3206 3207 1117 1082 1100 1100 1082 163 1081 1081 1109 1100 1082 1082 1100 1081 1082 1082 1081 1109 1082 1100
1079 1103 1105 1117 3208 3209 1123 1082 1081 1112 1135 1088 163 1082 76 1079 1126 1132 1099 1131 1109 1082 1102 77 78 1102 1112 1102 1102 1132 48 1080 21558 21558 1079 1117 1100 1110 1082 163 1082 1082 1082 1082 3208 3209 1108 1081 1082 1100 1081 163 1081 1081 1112 1100 1081 1081 1100 1110 1081 1081 1110 1112 1081 1082
1079 1106 1087 1133 3206 3207 1126 1082 1088 1082 1100 1100 173 1081 1101 1079 1108 1102 1081 1102 1112 1081 1100 1112 1100 1100 1081 1100 1100 1100 173 1089 1111 1026 1089 1133 1082 1081 1100 163 1082 1081 1110 1081 3206 3207 1123 1081 1082 1100 1081 163 1082 1081 1082 1100 1110 1081 1100 1081 1081 1081 1081 1082 1081 1082
1089 1111 1026 1089 3208 3209 1089 1111 1026 1026 1026 1026 1026 1026 1138 1139 1140 1026 1026 1026 1026 1026 1026 1026 1026 1026 1026 1026 1026 1026 1026 1026 1089 1100 1109 1082 1100 1100 1100 163 1082 1100 1082 1082 3208 3209 1126 1082 171 171 1082 163 1081 1081 1081 1109 1081 1082 1100 1100 1109 1109 1109 1109 1100 1109
1106 1087 1087 1087 3206 3207 1106 1134 1134 1099 1134 1099 1155 1099 1156 1143 211 145 0 0 0 0 0 0 0 0 0 0 0 0 48 0 1080 1100 1112 1081 1082 1082 1100 1136 1100 1082 1081 1081 3206 3207 1126 1081 208 161 1081 159 1081 1082 1102 161 1081 1081 1082 1082 1113 1122 1122 1114 1108 1112
1108 1109 1100 1100 3131 3132 67 68 67 68 67 68 67 68 59 12348 0 171 0 176 177 0 0 0 0 0 0 176 177 0 173 0 12347 60 67 68 67 68 67 68 67 68 67 68 3131 3132 1126 1081 1112 1112 1081 163 1082 1081 1100 1112 1081 1081 1100 1100 1115 1125 1125 1116 1123 1082
1108 1112 1082 1109 3133 3134 69 70 69 70 69 70 69 70 61 12350 0 0 51 178 179 0 0 0 0 51 0 178 179 0 51 0 12349 62 69 70 69 70 69 70 69 70 69 70 3133 3134 1108 1082 1082 1082 1082 163 1081 1081 1088 1100 1082 1082 1082 1082 1115 1125 1125 1116 1126 1082
1117 1081 1081 1112 1087 1099 1087 1099 1087 1099 1087 1087 1155 1099 1157 1089 1111 1026 1026 1026 1026 1026 1026 1026 1026 1026 1026 1026 1026 1026 1026 1026 1089 1106 1134 1099 1087 1134 1087 1099 1087 1134 1087 1099 1087 1099 1133 1082 1081 1081 1081 163 1082 1082 1081 1100 1081 1082 1110 1082 1115 1125 1125 1116 1126 1082
