48 70
1079 0 0 0 0 44 0 0 0 44 0 0 0 0 0 0 0 0 44 0 0 0 0 0 0 0 0 0 0 0 0 0 0 44 0 0 0 0 0 0 0 0 1079 0 0 0 1079 1080
1079 0 0 0 0 103 0 0 0 44 0 0 0 0 0 0 0 0 44 0 0 0 0 0 0 0 0 0 0 0 0 0 0 44 0 0 0 0 0 0 0 0 1079 0 0 0 1079 1081
1079 0 0 0 0 46 104 104 104 46 105 104 106 104 104 105 104 106 46 0 0 0 0 0 0 0 0 0 0 0 0 0 0 46 105 104 104 104 104 104 104 104 1079 104 104 46 1079 1082
1079 0 12288 12288 12288 12288 12288 12288 12288 12288 12288 12288 12288 12288 12288 12288 12288 12288 12288 12288 12288 12288 12288 12288 12288 12288 12288 12288 12288 12288 12288 12288 12288 12288 12288 12288 12288 12288 12288 12288 12288 12288 1079 0 0 107 1079 1083
1079 0 0 0 0 0 0 0 0 0 0 0 0 0 0 0 0 0 0 0 0 0 0 0 0 0 0 0 0 0 0 0 0 0 0 0 0 0 0 0 0 0 1084 0 0 44 1079 1085
1079 0 0 0 0 0 0 0 0 0 0 0 0 0 0 0 0 0 0 0 0 0 0 0 0 0 0 0 0 0 0 0 0 0 0 0 0 0 0 0 0 0 0 0 0 44 1079 1086
1079 0 0 0 108 109 0 0 0 0 0 0 0 0 0 0 0 0 0 0 0 0 0 0 0 0 0 0 0 0 0 0 0 0 0 0 0 0 0 0 0 0 1084 0 0 103 1079 1082
1084 1087 1026 1084 4130 4131 1084 1084 11264 11264 11264 11264 11264 11264 11264 11264 11264 11264 11264 11264 11264 11264 11264 11264 11264 11264 11264 11264 11264 11264 11264 11264 11264 11264 11264 11264 1084 0 0 1084 1087 1026 1084 1087 1026 1026 1084 1087
1080 1088 1088 1089 3106 3107 1089 1089 20530 20530 20530 20530 20530 20530 20530 20530 20530 20530 20530 20530 20530 20530 20530 20530 20530 20530 20530 20530 20530 20530 20530 20530 20530 20530 20530 20530 1089 0 0 1089 0 0 0 0 0 107 0 0
1090 1091 1082 1079 3106 3107 1084 1084 1084 1087 1026 1026 1026 1026 1026 1026 1026 1026 1026 1026 1026 1026 1026 1026 1026 1026 1026 1026 1026 1026 1026 1026 1026 1026 1026 1026 1084 0 0 1084 0 0 0 0 0 44 0 0
1092 1093 1081 1079 3106 3107 53 45 1089 0 0 0 0 0 0 0 0 0 0 0 0 0 0 0 0 0 49 0 0 0 0 0 0 0 0 0 0 0 0 0 0 0 1084 1084 1094 44 0 0
1090 1091 1082 1079 3106 3107 53 45 1079 0 0 0 110 111 0 0 0 0 0 0 0 0 0 0 0 0 112 113 0 0 0 0 0 0 110 111 0 0 0 0 0 0 1089 1089 0 44 0 0
1092 1093 1083 1079 3106 3107 53 45 1079 0 0 49 47 48 0 0 49 0 0 0 0 0 0 0 49 0 114 115 0 0 0 49 0 0 47 48 0 0 0 0 49 0 1079 1079 0 44 0 0
1090 1091 1081 1079 3106 3107 53 45 1084 1087 1026 1026 1026 1026 1026 1026 1026 1026 1026 1084 5162 5162 5162 5162 1095 1087 1084 1087 1026 1026 1026 1084 1087 1026 1026 1084 1087 1026 1026 1026 1026 1026 1084 1079 0 44 1084 1096
1097 1098 1082 1079 3106 3107 53 45 0 0 0 103 0 0 0 0 0 0 0 1084 5163 5163 5163 5163 1084 0 1089 1090 1099 1091 1080 1089 1080 0 0 1089 1090 1099 1099 1099 1099 1091 1089 1079 0 44 1089 1081
1092 1093 1083 1079 3106 3107 53 45 0 0 0 46 0 0 49 0 0 0 0 1084 46 0 0 0 0 0 1079 1097 1100 1098 1083 1079 1083 0 0 1079 1092 1101 1101 1101 1101 1093 1079 1079 0 44 1079 1081
1080 1102 1103 1079 3106 3107 53 12333 0 0 0 44 0 112 113 0 110 111 0 0 107 0 0 0 0 0 1079 1097 1100 1098 1085 1084 1087 1026 1026 1084 1087 1026 1026 1026 1026 1026 1084 1079 0 44 1079 1082
1081 1104 1105 1079 3106 3107 53 12333 0 0 0 103 49 114 115 0 47 48 0 1084 44 0 0 0 0 0 1079 1092 1100 1100 1091 1089 1080 46 105 104 104 104 104 104 104 104 104 1079 104 46 1079 1083
1087 1026 1026 1084 1087 1084 53 45 1084 1087 1026 1026 1026 1026 1026 1026 1026 1026 1026 1084 44 0 0 0 1084 1087 1084 1080 1097 1100 1098 1079 1083 44 0 0 0 0 0 0 0 0 0 1079 0 0 1079 1082
1080 116 1102 1088 1102 1089 53 45 1089 1090 1099 1091 1080 1102 1102 1102 1088 1088 1088 1089 103 0 0 0 1089 1080 0 1083 1097 1100 1098 1079 1085 44 0 0 0 0 0 0 0 0 0 1079 0 0 1079 1083
1082 1106 1105 1107 1108 1079 53 45 1079 1097 1100 1098 1082 1105 1109 1104 1109 1109 1084 1084 46 105 104 106 1079 1081 1090 1099 1100 1101 1093 1079 0 44 0 0 0 0 0 0 0 0 0 1079 0 0 1079 1081
1081 46 1107 1107 1106 1079 53 45 1079 1097 1100 1098 1083 1107 1108 1107 1108 1108 1089 0 0 0 0 0 1079 1082 1097 1100 1098 1080 1102 1079 0 44 1110 1111 1111 1112 0 0 0 0 0 1079 0 0 1079 1081
1082 107 1108 1107 1113 1079 53 45 1079 1092 1101 1093 1083 1105 1105 1109 1084 1087 1084 0 0 0 0 0 1079 1083 1097 1100 1098 1084 1087 1084 0 44 0 0 0 0 0 0 0 0 0 1079 0 0 1079 1082
1083 44 1109 1107 1109 1079 53 45 1079 1080 1102 1102 1103 1104 1107 1108 1089 0 0 0 0 0 0 117 1079 1085 1092 1101 1093 1089 0 0 0 44 0 0 0 0 0 0 0 0 0 1079 0 0 1079 1083
1085 44 1105 1109 1105 1079 53 45 1079 1082 1105 1104 1105 1105 1084 1087 1084 0 0 0 0 0 117 20531 1084 1086 116 1084 1087 1084 0 0 0 44 0 0 1114 1115 1115 1116 0 0 0 1079 0 0 1079 1082
1086 44 1107 1107 1107 1079 53 45 1079 1083 1107 1107 1107 1107 1089 0 0 0 0 0 0 117 20531 20575 116 1103 1109 1089 0 10240 0 0 0 44 0 0 0 0 0 0 0 0 0 1079 0 0 1079 1083
1081 44 1108 1109 1109 1079 53 45 1084 1087 1026 1084 1087 1026 1084 0 0 0 0 0 117 20531 20575 1117 1107 1108 1107 1079 0 10240 0 0 0 44 0 0 0 0 0 0 0 0 0 1079 0 0 1079 1081
1081 44 1106 1104 1105 1079 53 45 1079 1080 116 1089 118 0 0 0 0 0 0 117 20531 20575 1117 1105 1109 1105 1109 1079 0 10240 0 0 0 44 0 0 0 0 0 0 0 0 0 1079 0 0 1079 1081
1082 46 105 1108 1107 1079 53 45 1079 1081 1109 1079 46 0 0 0 0 0 117 20531 20575 1117 1107 1108 1108 1108 1108 1079 0 10240 0 0 0 44 0 0 0 0 0 0 0 0 0 1079 0 0 1079 1082
1083 44 1118 1107 1104 1079 53 45 1079 1083 1107 1079 107 0 0 0 0 117 20531 20575 1117 1105 1109 1106 1108 1107 1109 1079 0 10240 0 0 0 44 0 0 0 0 0 0 0 0 0 1079 0 0 1079 1083
1083 1113 1105 1109 1108 1079 53 45 1079 1083 1107 1079 44 0 0 0 117 20531 20575 1117 1106 1108 1108 1113 1105 1108 1107 1079 0 10240 0 0 0 103 0 0 0 0 0 0 0 0 0 1079 0 0 1079 1082
1082 1109 1107 1107 1105 1079 53 45 1084 1087 1026 1084 44 0 0 0 20531 1119 1117 1105 0 1106 1109 1109 1108 1105 1109 1079 0 10240 0 0 0 46 105 104 104 104 104 104 104 104 104 1079 46 104 1079 1083
1083 1108 1109 1109 1107 1079 53 45 0 0 0 0 5164 5120 5120 5120 1084 1083 1107 1107 0 1113 1108 1109 1106 1108 1108 1079 0 10240 0 0 0 0 0 0 0 0 0 0 0 0 0 1079 0 0 1079 1081
1026 1026 1026 1026 1026 1084 53 45 1084 1087 1026 1084 44 0 0 0 1084 1087 1084 1083 1113 1109 1109 1109 1113 1106 1109 1079 0 10240 0 0 0 0 0 0 0 0 0 0 0 0 0 1079 0 0 1079 1081
1080 1102 1102 0 116 1089 53 45 1089 1080 116 1089 103 0 0 119 118 0 1089 1083 1109 1109 1108 1109 1109 1113 1108 1079 0 10240 1110 1111 1111 1112 0 0 0 0 0 0 0 0 0 1079 0 0 1079 1082
1081 1109 1105 0 1109 1079 53 45 1079 1081 1109 1079 46 105 104 106 46 120 1084 1087 1084 1109 1109 46 1109 1109 1109 1079 0 10240 0 0 0 0 0 0 0 0 0 0 0 0 0 1079 0 0 1079 1083
1082 1108 1107 0 1108 1079 53 45 1079 1082 1108 1079 107 0 0 0 0 0 0 0 1089 1109 1108 107 1109 1109 1108 1079 0 10240 0 0 0 0 0 0 0 0 0 0 0 0 0 1079 0 0 1079 1082
1081 1105 1107 0 1109 1079 53 45 1079 1083 1109 1079 103 121 0 0 0 0 0 0 1084 1087 1084 44 1109 1109 1109 1079 0 0 0 0 0 0 0 0 1114 1115 1115 1116 0 0 0 1079 0 0 1079 1083
1082 1107 1107 0 1108 1079 53 45 1079 1082 1108 1084 1087 20532 121 0 0 0 0 0 0 0 1089 103 1108 1109 1108 1084 1084 0 0 1084 0 0 0 0 0 0 0 0 0 0 0 1079 0 0 1079 1081
1083 1120 1120 0 1105 1079 53 45 1079 1083 1105 1089 107 1055 20532 121 0 0 0 0 0 0 1084 1087 1084 1081 1105 1121 1089 0 0 1089 0 0 0 0 0 0 0 0 0 0 0 1079 0 0 1079 1081
1082 1090 1099 1091 1107 1079 53 45 1079 1085 1107 1079 44 122 1055 20532 121 0 0 0 0 0 0 0 1089 1082 1107 1105 1079 0 0 1079 0 0 0 0 0 0 0 0 0 0 0 1079 0 0 1079 1082
1083 1097 1100 1098 1108 1079 53 45 1079 1086 1108 1079 44 123 122 1055 20532 121 0 0 0 0 0 0 1084 1087 1084 1081 1079 0 0 1079 0 0 0 0 0 0 0 0 0 0 0 1079 0 0 1079 1083
1085 1092 1101 1093 1106 1079 53 45 1079 1081 1106 1079 44 124 125 122 1055 20532 121 0 0 0 0 0 0 0 1089 1081 1079 0 0 1079 0 0 0 0 0 0 0 0 0 0 0 1079 0 0 1079 1082
1086 44 116 116 1118 1079 53 45 1079 1082 1118 1079 44 123 0 126 122 1056 20532 121 0 0 0 0 0 0 1079 1082 1079 0 0 1079 0 0 0 0 0 0 0 0 0 0 0 1079 0 0 1079 1083
1081 44 1109 1109 1105 1079 53 45 1079 1081 1105 1079 46 124 0 126 127 1057 1055 20532 0 0 0 0 0 0 1079 1083 1079 0 0 1079 0 0 0 0 0 0 0 0 0 0 0 1079 0 0 1079 1081
1082 103 1106 1106 1107 1079 53 45 1084 1087 1026 1084 1087 1026 1026 4098 4098 1026 1026 1084 1087 1122 0 0 0 0 1079 1082 1079 0 0 1079 0 0 0 0 0 0 0 0 0 0 0 1079 0 0 1079 1081
1081 46 1113 120 1109 1079 53 45 0 0 0 0 118 0 0 3108 3109 0 0 1084 1084 1084 0 0 0 0 1079 1083 1079 0 0 1079 105 104 104 104 106 46 105 104 104 104 104 1079 104 104 1079 1082
1081 1118 1109 1118 1108 1079 53 45 0 0 112 113 110 111 0 3110 3111 0 0 0 0 0 5120 5120 5120 5120 1084 1087 1084 0 0 1084 0 0 0 0 0 44 0 0 0 0 0 1079 0 0 1079 1083
1082 1105 1108 1105 1106 1079 53 45 0 0 114 115 47 48 0 3112 3113 0 0 1084 1084 1084 0 0 0 0 1089 1080 1089 0 0 1089 0 0 0 0 0 103 0 0 0 0 0 1079 0 0 1079 1082
1087 1026 1026 1026 1026 1084 53 45 1084 1087 1026 1026 1026 1026 1084 1087 1026 1026 1026 1084 1089 0 0 0 0 0 1079 1082 1079 0 0 1079 105 104 104 104 106 46 0 0 0 0 0 1079 0 0 1079 1083
1090 1091 1080 1088 1088 1089 53 45 1089 1080 1088 1090 1099 1091 1089 1080 1088 1088 1084 1087 1084 0 0 0 0 0 1079 1083 1079 0 0 1079 0 0 0 0 0 0 0 0 0 0 0 1079 0 0 1079 1083
1123 1098 1081 1107 1107 1079 53 45 1079 1081 1107 1097 1100 1098 1079 1081 1107 1107 1089 0 0 0 0 0 0 0 1079 1083 1079 0 0 1079 0 0 0 0 0 0 0 0 0 0 0 1079 0 0 1079 1081
1124 1098 1082 1109 1109 1079 53 45 1079 1082 1109 1092 1101 1093 1079 1082 1084 1087 1084 0 0 0 0 0 117 0 1079 1082 1079 0 0 1079 0 0 0 0 0 0 0 0 0 0 0 1079 0 0 1079 1081
1092 1100 1091 1081 1107 1079 53 45 1079 1083 1106 44 116 116 1079 1083 1089 107 0 0 0 0 0 117 20531 1026 1084 1087 1084 0 0 1079 0 0 0 0 0 0 0 0 0 0 0 1079 0 0 1079 1082
1080 1123 1098 1081 1104 1084 53 45 1084 1084 1087 1026 1026 1026 1084 1087 1084 44 0 0 0 0 117 20531 20575 1102 1102 1117 1089 0 0 1079 0 0 0 0 0 0 0 0 0 0 0 1079 0 0 1079 1083
1081 1124 1098 1082 1107 1089 53 45 1089 1089 0 107 0 0 0 0 12288 103 0 0 0 117 20531 20575 1117 1109 1090 1091 1079 0 0 1079 0 0 0 0 0 0 0 0 0 0 0 1079 0 0 1079 1082
1082 1124 1098 1081 1109 1079 53 45 1079 1079 0 103 0 0 110 111 12288 44 0 0 117 20531 20540 1083 1107 1107 1097 1098 1079 0 0 1079 0 0 0 0 0 0 0 0 0 0 0 1079 0 0 1079 1083
1083 1123 1098 1082 1107 1079 53 45 1079 1079 12288 12334 12288 12288 12335 12336 12337 103 0 0 20531 1119 1089 1083 1109 1109 1097 1098 1079 0 0 1079 0 0 0 0 0 0 0 0 0 0 0 1079 0 0 1079 1081
1085 1124 1100 1099 1091 1079 53 45 1079 1079 0 107 0 1084 1087 1026 1026 1026 1026 1026 1084 1087 1084 1090 1099 1099 1101 1093 1079 0 0 1079 0 0 0 0 0 0 0 0 0 0 0 1079 0 0 1079 1081
1086 1092 1101 1100 1098 1079 53 45 1079 1079 0 44 0 0 0 0 0 0 0 0 0 107 1089 1097 1100 1098 0 0 1079 0 0 1079 0 0 0 0 0 0 0 0 0 0 0 1079 0 0 1079 1082
1081 1088 1102 1124 1098 1079 53 45 1079 1079 0 44 0 0 0 0 0 110 111 0 0 107 1079 1097 1100 1098 0 0 1079 0 0 1079 0 0 0 0 0 0 0 0 0 0 0 1079 0 0 1079 1083
1082 1109 1105 1092 1093 1079 53 45 1079 1079 0 44 0 0 0 0 0 47 48 0 0 103 1079 1097 1100 1098 0 0 1079 0 0 1079 0 0 0 0 0 0 0 0 0 0 0 1079 0 0 1079 1083
1087 1026 1026 1084 1084 1084 53 45 1084 1084 1084 1087 1026 1026 1026 1026 1026 1026 1026 1084 0 46 1079 1097 1100 1100 1099 1091 1079 0 0 1079 46 105 104 106 46 105 104 104 104 104 104 1079 104 104 1079 1081
1090 1099 1091 1084 1125 21504 21557 21549 21504 1126 1084 1102 1088 1102 1102 1088 1102 1102 1088 1089 0 107 1079 1092 1101 1101 1101 1093 1079 0 0 1079 107 0 0 0 107 0 0 0 0 0 0 1079 0 0 1079 1081
1097 1100 1098 1084 1084 1084 53 45 1084 1084 1084 1087 1026 1026 1026 1026 1026 1026 1026 1084 0 44 1084 1087 1026 1026 1026 1026 1084 0 0 1079 44 0 0 0 44 0 0 0 0 0 0 1084 0 0 1079 1082
1097 1100 1098 1089 0 0 53 45 0 0 0 46 0 0 0 0 0 0 0 0 0 44 0 0 0 0 128 129 0 0 0 1079 44 0 0 0 44 0 0 0 0 0 0 0 0 0 1079 1083
1097 1100 1098 1079 110 111 53 45 0 0 0 107 0 0 130 131 0 0 0 0 0 44 132 0 0 0 133 134 0 0 0 1079 44 0 0 0 44 0 0 0 132 0 0 0 0 0 1079 1082
1097 1100 1098 1079 47 48 53 45 0 0 49 103 0 0 0 0 0 0 135 0 0 49 127 0 135 0 38 39 0 0 0 1079 44 0 0 0 103 135 0 0 127 0 0 0 0 0 1079 1083
1097 1100 1098 1084 1087 1084 53 45 1084 1087 1026 1026 1026 1026 1026 1026 1026 1026 1026 1026 1026 1026 1026 1026 1026 1026 1026 1026 1084 0 0 1084 1087 1026 1026 1026 1026 1026 1026 1026 1026 1026 1026 1084 0 0 1084 1082
1092 1101 1093 1089 1080 1084 21558 21558 1084 1080 1088 107 1088 1102 1088 1102 1088 1102 1102 1088 1102 1088 1102 1088 1102 1088 1088 1102 1084 22528 22528 1084 1102 1088 0 1102 107 1102 1088 0 1102 1088 1102 1084 22528 22528 1084 1082
