36 79
1075 1085 1075 1085 1075 1085 1075 1085 1075 1085 1075 1085 1075 1085 1075 1085 1075 1085 1075 1085 1075 1085 1075 1085 1075 1085 1075 1085 1075 1085 1075 1085 1075 1085 1075 1085
1085 1075 1085 1075 1085 1075 1085 1075 1085 1075 1085 1075 1085 1075 1085 1075 1085 1075 1085 1075 1085 1075 1085 1075 1085 1075 1085 1075 1085 1075 1085 1075 1085 1075 1085 1075
1115 0 0 0 0 0 0 32859 0 0 0 0 0 10240 139 140 140 140 140 140 140 141 10240 0 0 0 0 0 0 0 0 0 0 0 1108 1079
1116 0 0 0 0 0 0 32860 0 0 0 0 0 10240 0 0 0 0 0 0 0 0 10240 0 0 0 0 142 143 144 145 146 0 0 1106 1107
1115 0 0 0 0 0 0 32859 0 0 0 45 46 10374 0 0 0 0 0 0 0 0 10240 0 0 0 0 147 148 149 150 151 0 0 1108 1079
1116 0 0 0 0 0 0 1025 1025 49288 0 47 0 10375 0 0 0 0 0 0 0 0 10240 0 0 0 0 152 153 154 155 0 0 0 1106 1107
1115 0 0 0 0 0 0 1094 1094 1117 49288 48 49 50 0 0 0 0 0 0 0 0 0 0 0 0 1025 1025 1025 1025 1025 1025 32801 32801 1075 1085
1116 0 0 1055 21544 21544 21544 1056 1094 1094 1117 1025 1025 1025 0 0 0 0 0 0 0 0 0 0 0 0 1094 1094 1094 1094 1094 1094 32809 32809 1085 1075
1115 0 0 0 0 0 0 1106 1075 1085 1094 1094 1094 1094 0 0 0 0 0 0 0 0 0 0 0 0 1108 1079 1075 1085 1075 1085 32810 32811 1075 1085
1116 0 0 0 0 0 0 1108 1085 1075 1085 1075 1118 1116 0 0 0 0 0 0 0 0 0 0 0 0 1106 1107 1085 1116 0 0 0 0 1106 1075
1115 0 0 0 0 0 0 1106 1116 1119 1110 1106 1107 1115 22528 22528 0 0 0 0 0 0 0 0 0 0 1108 1079 1075 1115 0 0 0 0 1108 1079
1055 21544 21544 21544 1056 0 0 1108 1115 1109 1111 1108 1079 1116 0 0 0 0 0 0 0 0 0 0 0 0 1106 1107 1085 1116 0 0 0 0 1106 1107
1115 0 0 0 0 0 0 1106 1075 1085 1075 1085 1075 1115 0 0 0 0 0 0 0 0 0 0 0 0 1108 1079 1075 1115 0 0 0 0 1108 1079
1116 0 0 0 0 0 0 1108 1085 1075 1085 1075 1118 1116 0 0 0 0 0 0 0 0 0 0 0 0 1106 1107 1085 1116 1025 1025 0 0 1106 1107
1115 0 0 0 0 0 0 1106 0 0 0 0 0 0 0 0 0 0 0 0 0 0 0 0 0 0 1108 1079 1107 1085 1094 1094 22528 22528 1108 1079
1116 0 0 0 0 0 0 1116 0 0 0 0 0 0 0 0 0 0 0 0 0 0 0 0 0 0 1106 1075 1085 1107 1085 1107 1025 1025 1106 1107
1115 0 0 0 0 0 0 0 0 0 0 0 0 0 0 0 0 0 0 0 0 0 0 0 0 0 1108 1079 1075 1079 1075 1079 1094 1094 1107 1085
1116 0 0 0 0 0 0 0 0 0 0 0 0 0 0 0 22528 22528 0 0 0 0 0 0 0 0 1106 1107 1085 1116 1119 1110 1106 1107 1085 1075
1115 0 0 0 0 0 0 0 0 0 0 0 0 0 0 0 0 0 0 0 0 0 0 0 0 0 1108 1079 1075 1115 1109 1111 1108 1079 1075 1085
1116 1025 1025 1025 1025 1025 1025 1025 0 0 0 0 0 0 0 0 0 0 0 0 0 0 0 0 0 0 1106 1107 1085 1107 1085 1107 1085 1107 1085 1107
1085 1094 1094 1094 1094 1094 1094 1094 0 0 0 0 0 0 0 0 0 0 0 0 0 0 0 0 0 0 1108 1079 1075 1079 1075 1079 1075 1079 1107 1085
1118 1107 1079 1075 1079 1075 1118 1116 0 0 0 0 0 0 0 0 0 0 0 0 0 0 0 0 0 0 0 0 0 0 0 0 0 0 1106 1107
1075 1085 1116 1119 1110 1106 1075 1115 0 0 0 0 0 0 0 0 0 0 0 0 0 0 0 0 0 0 0 0 0 0 0 0 0 0 1108 1079
1118 51 1115 1109 1111 1108 1118 1116 0 0 0 0 0 0 0 0 0 0 0 10240 139 140 140 140 141 10240 0 0 0 0 0 0 0 0 1106 1107
1075 1079 1107 1085 1107 1085 1075 1115 1025 1025 0 0 22528 22528 0 0 0 0 0 10240 0 0 0 0 0 10240 0 0 0 37 38 0 0 0 1108 1079
1118 1107 1079 1075 1079 1075 1118 1094 1094 1094 0 0 0 0 0 0 0 0 0 10240 0 0 0 0 0 10240 1025 1025 1025 4133 4134 1025 1025 1025 1106 1107
1075 1079 1107 1085 1107 1085 1075 1079 1075 1079 0 0 0 0 0 0 0 0 0 10240 0 0 0 0 0 10240 1094 1094 1094 3109 3110 1094 1094 1094 1075 1085
1118 1075 1079 1075 1079 1075 1118 1075 1079 1075 0 0 0 0 0 0 0 22528 22528 0 0 0 0 0 0 0 0 0 0 3109 3110 0 0 0 1085 1075
1075 1079 32851 32859 0 0 0 0 0 0 0 0 0 0 0 0 0 0 0 0 0 0 0 0 0 0 0 0 0 3109 3110 0 0 0 1108 1079
1118 1107 32823 32860 0 0 0 0 0 0 0 0 0 0 0 0 0 0 0 0 0 0 0 0 52 53 54 0 0 3109 3110 0 0 0 1106 1107
1075 55 32851 32859 0 0 0 0 0 0 0 0 0 0 0 0 0 156 157 0 0 0 0 0 56 0 57 0 0 3109 3110 0 0 0 1108 1079
1085 1075 1085 1116 1025 1025 1025 32812 32812 1025 1025 1025 51337 52362 0 0 0 158 159 0 0 0 0 0 58 59 60 160 0 3109 3110 0 0 0 1106 1107
1075 1085 1107 1115 1094 0 0 0 0 1094 1094 1094 1120 1121 1025 1025 1025 1025 1025 1025 1025 1025 1025 1025 1025 1025 1025 1025 1025 1025 1025 1025 1025 1025 1075 1085
1085 1075 1085 1075 1115 0 0 0 0 1108 1085 1075 1094 1094 1094 1094 1094 1094 1094 1094 1094 1094 1094 1094 1094 1094 1094 1094 1094 1094 1094 1094 1094 1094 1085 1075
1075 1085 1075 1085 1116 0 0 1025 1025 1106 1075 1085 1075 1085 1075 1085 1075 1085 1075 1085 1075 1085 1075 1085 1116 1119 1110 1106 1075 1085 51 61 1075 1085 1075 1085
1085 1075 1085 1075 1115 0 0 1094 1094 1108 1085 1075 1085 1075 1085 1075 1085 51 61 1075 1085 1075 1085 1075 1115 1109 1111 1108 1085 1075 1085 51 61 1075 1085 1075
1075 1085 1075 1085 1116 0 0 0 0 0 0 1108 1085 1075 1122 1123 1124 62 63 1125 1126 1127 1075 1085 51 61 1075 1085 1075 1085 1116 1119 1110 1106 1075 1085
1085 1075 1085 1075 1115 0 0 0 0 0 0 1106 1075 1085 1128 1129 1130 64 65 1131 1132 1133 1085 1075 1085 1075 1085 1075 1085 1075 1115 1109 1111 1108 1085 1075
1075 1085 1075 1085 1116 1025 1025 1025 1025 0 0 1108 1085 1075 1122 1134 1135 66 67 1135 1136 1127 1075 1085 51 61 1075 1085 1075 1085 1075 1085 1075 1085 1075 1085
1075 1085 1085 1075 1115 1094 1094 1094 1094 0 0 0 0 0 0 0 0 68 69 0 0 0 0 0 0 0 0 0 1106 1107 1085 1075 1085 1075 1085 1075
1075 1115 0 0 0 0 0 0 0 0 0 0 0 0 0 12288 0 0 0 0 0 0 0 0 0 0 0 0 1108 1079 1075 1115 0 0 0 0
1085 1116 156 157 0 0 0 0 0 0 0 0 0 0 0 12288 0 0 0 0 0 0 0 0 0 0 0 0 1106 1107 1085 1116 0 0 0 0
1075 1115 158 159 161 0 0 0 0 0 0 0 0 0 0 12288 0 0 0 0 0 0 0 0 0 0 0 0 1108 1079 1075 1115 0 0 0 0
1085 1116 1025 1025 1025 1025 1025 1025 1025 1025 1025 1025 1025 1025 1025 1137 1138 1138 1138 1138 1138 1138 1139 0 0 0 0 0 1106 1107 1085 1116 0 0 0 162
1075 1085 1094 1094 1094 1094 1094 1094 1094 1094 1094 1094 1094 1094 70 70 1094 1094 1094 70 70 1094 1094 0 0 0 0 0 1108 1079 1075 1115 1025 4228 4229 1025
1075 1085 1079 1116 1119 1110 1106 1075 1085 1075 1085 1075 1115 1140 62 63 1125 1125 1125 62 63 1141 1115 0 0 0 0 0 1106 1107 1085 1075 1115 3198 3199 1094
1085 1075 1107 1115 1109 1111 1108 1085 1075 1085 1075 1085 1116 1142 64 65 1131 1131 1131 64 65 1143 1116 0 0 0 0 0 71 72 73 74 73 3200 3201 1106
1075 1115 1085 1075 1085 1075 1085 1075 1085 1075 1085 1075 1115 1144 66 67 1144 1144 1144 66 67 1144 1115 1025 1025 0 0 0 75 76 77 78 77 3202 3203 1108
1118 1116 163 164 1075 1085 0 0 0 0 0 0 0 0 68 69 0 0 0 68 69 0 0 0 0 0 0 0 1094 1094 1094 1094 1094 4228 4229 1106
1118 1116 163 164 0 0 0 0 0 0 0 0 0 0 0 0 0 0 0 0 0 0 0 0 0 0 0 0 1106 1107 1119 1110 1115 3198 3199 1108
1075 1115 163 164 0 0 0 0 0 0 0 0 0 0 0 0 0 0 0 0 0 0 0 0 0 0 0 0 1108 1079 1109 1111 1116 3204 3205 1106
1118 1116 163 164 0 0 0 0 0 0 0 0 0 0 0 0 0 0 0 0 0 0 0 0 0 0 0 0 1106 1075 1085 1075 1115 3198 3199 1108
1075 1115 163 164 1025 1025 11264 11264 11264 1057 1057 1057 1145 1146 1146 1146 1146 1146 1146 1146 1146 1146 1146 1146 1146 1146 1146 1147 1116 0 0 0 0 3143 3144 1106
1118 1116 163 164 1094 1094 165 0 0 79 80 1094 1094 1094 1094 1094 1094 1094 1094 1094 1094 1094 1094 1094 1094 1094 1094 1094 1094 162 0 0 0 3147 3148 1075
1075 1115 163 164 1106 1116 20519 165 0 0 81 82 1107 1085 1107 1085 1075 1085 1075 1085 1075 1085 1075 1085 1075 1085 1075 1085 1116 1025 1025 1025 1025 1025 1025 1085
1118 1116 163 164 1108 1115 1117 20519 165 0 0 0 0 0 1106 1107 1085 1075 1085 1075 1085 1075 1085 1075 1085 1075 1085 1075 1115 1094 1094 1094 1094 1094 1094 1075
1075 1115 163 164 1108 1116 1094 1117 20519 165 0 0 0 0 1108 1079 1075 1118 1116 0 0 0 0 0 0 0 0 1106 1107 1085 1107 1085 1107 1085 1107 1085
1118 1116 163 164 1106 1085 1116 1094 1117 20519 0 0 0 0 1106 1107 1085 1075 1115 0 0 0 0 0 0 0 0 1108 1079 1107 1079 1075 1079 1075 1079 1075
1075 1115 163 164 1108 1107 1079 1116 1094 1117 0 0 0 0 1108 1079 1075 1118 1116 0 0 0 0 0 0 10240 10240 1106 1107 1085 1116 1119 1110 1106 1075 1085
1118 1116 163 164 1106 1075 1085 1075 1115 1094 0 0 0 0 1106 1107 1085 1075 1115 0 0 0 0 0 0 0 0 1108 1079 51 1115 1109 1111 1108 1085 1075
1075 1115 163 164 0 0 0 0 0 0 0 0 0 0 1108 1079 1075 1118 1116 0 0 0 0 0 0 0 0 82 83 55 83 1085 1107 1085 1107 1085
1118 1116 163 164 0 0 0 0 0 0 0 0 166 167 1106 1107 1085 1075 1115 0 0 0 0 0 0 0 0 84 55 83 55 1075 1079 1075 1079 1075
1075 1115 163 164 0 0 0 0 0 0 0 162 168 169 1108 1079 1075 1118 1116 0 0 0 0 0 0 0 0 82 83 55 51 1079 1075 1079 1075 1079
1118 1116 163 164 1025 1025 1025 1025 1025 1025 1025 1025 1025 1025 1085 1075 1085 1075 1115 0 0 0 0 0 0 0 0 1108 1079 1107 1079 1075 1079 1075 1079 1075
1075 1115 163 164 1094 1094 1094 1094 1094 1094 1094 1094 1094 1094 1075 1085 1075 1118 1116 0 0 0 0 0 0 0 0 1106 1107 1079 1075 1079 1075 1079 1075 1079
1118 1116 163 164 1106 1075 1085 1075 1085 1075 1085 1075 1085 1116 1119 1110 1106 1075 1115 0 0 0 0 0 0 0 0 1106 1116 170 171 171 171 172 173 1108
1075 1115 163 164 1108 1085 1075 1085 1075 1085 51 1085 1075 1115 85 1111 1108 1085 1116 0 0 0 0 0 0 0 0 1108 1115 174 175 175 175 176 177 1106
1118 1116 163 164 1106 1075 1085 1075 1085 1075 61 1075 1085 1075 61 1075 1085 1075 1115 0 0 0 0 0 0 0 0 0 0 0 178 0 178 0 0 1108
1075 1115 163 164 1108 1148 1148 1119 1110 1119 86 1119 1110 1119 86 1148 1148 1106 1116 0 0 0 0 0 0 0 0 1108 1115 0 1058 0 1058 0 0 1106
1118 1116 163 164 1106 1149 1149 1109 1111 1109 87 1109 1111 1109 87 1149 1149 1108 1115 0 0 0 0 0 0 0 0 1106 1116 0 1059 0 1059 0 0 1108
1075 1115 163 164 0 88 88 0 0 0 89 0 0 0 89 88 88 0 0 0 0 0 0 0 0 0 0 1108 1115 0 1060 0 1060 0 0 1106
1118 1116 163 164 0 0 0 0 0 0 0 0 0 0 0 0 0 0 0 0 0 0 0 0 0 10240 10240 0 0 0 0 0 0 0 0 1108
1075 1115 163 164 0 0 0 0 0 0 0 0 0 0 0 0 0 0 0 0 0 0 0 0 0 0 0 0 0 0 0 0 0 179 180 1106
1118 1116 163 164 0 0 0 90 0 0 0 90 0 0 0 0 0 0 0 0 0 0 0 0 0 0 0 0 0 0 0 0 0 0 0 1108
1075 1115 163 164 1025 1025 1025 5121 1025 1025 1025 5121 1025 1025 1025 1025 1025 1025 1025 1025 1057 1057 1057 1057 1057 1057 1025 1025 1025 1025 1025 1025 1025 1025 1025 1106
1085 1116 40 40 1094 1094 1094 70 1094 1094 1094 70 1094 1094 1094 1094 1094 1094 1094 1094 1094 1094 1094 1094 1094 1094 1094 1094 1094 1094 1094 1094 1094 1094 1094 1094
1075 1085 1025 1025 1075 1085 1075 61 1075 1085 1075 61 1075 1085 1075 1085 1075 1085 1075 1085 1075 1085 1075 1085 1075 1085 1075 1085 1075 1085 1075 1085 1075 1085 1075 1085
1085 1075 1094 1094 1085 1075 1085 51 1085 1075 1085 51 1085 1075 1085 1075 1085 1075 1085 1075 1085 1075 1085 1075 1085 1075 1085 1075 1085 1075 1085 1075 1085 1075 1085 1085
1075 1085 1075 1085 1075 1085 1075 1085 1075 1085 1075 1085 1075 1085 1075 1085 1075 1085 1075 1085 1075 1085 1075 1085 1075 1085 1075 1085 1075 1085 1075 1085 1075 1085 1075 1085
