45 49
1104 1105 0 0 0 0 1106 1107 1108 1109 1076 1109 1076 1109 1076 1109 1076 1109 1076 1109 1076 1109 1076 1109 1108 1109 1108 1109 1076 1109 1108 1109 1108 1109 1108 1109 1108 1109 1108 1109 1108 1109 1108 1109 1108
1075 1110 0 0 0 0 1111 1076 1109 1076 1107 1108 1107 1108 1107 1108 1107 1108 1107 1108 1107 1108 1109 1104 1105 0 0 117 1111 1110 0 0 0 0 0 0 0 0 0 0 0 0 0 1106 1107
1104 1105 0 0 0 0 1106 1107 1108 1107 1076 1109 1076 1109 1076 1109 1076 1109 1076 1109 1076 1109 1076 1109 1110 0 0 35 1106 1105 10240 10240 0 0 0 0 0 0 0 0 0 0 0 1111 1076
1075 1110 0 0 0 0 1111 1076 1109 1076 1109 1076 1109 1108 1107 1108 1107 1108 1107 1108 1109 1108 1109 1104 1105 0 0 35 1111 1110 0 0 0 0 0 0 0 0 0 0 0 0 0 1106 1107
1104 1105 0 0 0 0 39 40 41 42 43 44 1106 1075 1076 1109 1076 1109 1076 1109 1108 1109 1108 1109 1110 0 0 11299 0 0 0 0 0 0 0 0 0 0 0 0 0 0 0 1111 1076
1075 1110 0 0 0 0 45 46 47 48 49 50 1111 1108 1109 1108 1109 1108 1109 1108 1109 1108 1109 1104 1105 0 0 0 1106 1105 0 0 0 0 0 0 0 0 0 0 0 1025 1025 1106 1107
1104 1105 1025 1025 1025 1025 1112 1112 1112 1112 4135 4136 1106 1109 1110 0 0 0 0 0 0 1111 1108 1109 1110 0 0 0 1111 1110 0 0 0 0 0 0 0 0 0 0 0 1112 1112 1111 1076
1075 1110 1112 1112 1112 1112 1112 1112 1112 1110 3117 3118 1111 1104 1105 0 0 0 0 0 0 1106 1109 1104 1105 0 0 0 1106 1105 0 0 0 0 0 0 0 0 0 0 0 0 0 1106 1107
1104 1105 118 119 0 0 0 0 0 0 0 0 1106 1109 1110 0 0 0 0 0 0 0 0 0 0 0 0 0 0 0 0 0 0 0 0 0 0 0 0 0 0 0 0 1111 1076
1075 1110 118 119 0 0 0 0 120 121 120 0 1111 1104 1105 0 0 0 0 0 0 0 0 0 0 0 0 0 0 0 10240 10240 0 0 0 22528 22528 0 0 0 0 0 0 1106 1107
1104 1105 118 119 0 0 0 0 122 123 124 0 1106 1109 1110 0 0 0 0 0 0 0 0 0 0 0 0 0 0 0 0 0 0 0 0 0 0 0 0 0 0 0 0 1111 1076
1075 1110 118 119 0 0 0 0 125 126 127 0 1111 1108 1105 1025 1025 1025 1025 1025 1025 1025 1025 1025 1025 1025 0 0 1025 1025 0 0 0 0 0 0 0 0 0 0 0 0 0 1106 1107
1104 1105 118 119 1025 1025 5154 5154 1025 1025 1025 1025 1076 1109 1108 1112 1112 1112 1112 1112 1112 1112 1112 1112 1112 1112 0 0 1112 1112 0 0 0 0 0 0 0 0 0 0 0 0 0 1111 1076
1075 1110 118 119 1112 1112 0 0 1112 1112 1112 1112 1109 1108 1109 1108 1109 1108 1109 1108 1109 1108 1109 1108 1109 1108 1109 1108 1109 1110 1025 1025 0 0 0 0 0 0 0 0 0 0 0 1106 1107
1104 1105 118 119 1111 1110 0 0 0 0 0 0 0 0 0 0 0 0 0 0 0 0 0 0 0 0 0 0 0 0 0 0 0 0 0 0 0 0 0 0 0 0 0 1111 1076
1075 1110 118 119 1106 1105 0 0 0 0 0 0 0 0 0 0 0 0 0 0 0 0 0 0 0 0 0 0 0 0 0 0 0 0 0 0 0 0 0 22528 22528 0 0 1106 1107
1104 1105 118 119 1111 1110 0 0 0 0 0 0 0 0 0 0 0 0 0 0 0 0 0 0 0 0 0 0 0 0 0 0 0 0 0 0 0 0 0 0 0 0 0 1111 1076
1075 1110 118 119 1106 1105 0 0 1025 1025 4135 4136 1025 1025 1025 1025 1025 1025 1025 1025 1025 51315 52340 0 0 0 0 0 0 0 0 0 0 0 0 0 0 0 0 0 0 0 0 1106 1107
1104 1105 118 119 1111 1110 22528 22528 1112 1112 3117 3118 1112 1112 1112 1112 1112 1112 1112 1112 1112 1113 1114 51315 52340 0 0 0 0 0 0 0 0 0 0 0 0 0 0 0 0 0 0 1111 1076
1075 1110 118 119 1106 1075 1025 1025 1108 1109 3183 3184 1108 1109 1108 1109 1108 1109 1108 1109 1108 1112 1112 1113 1114 51315 52340 0 0 0 0 0 0 0 0 0 0 0 0 0 0 0 0 1106 1107
1104 1105 118 119 1111 1076 1112 1112 1075 1076 3185 3186 1075 1076 1075 1110 1115 1116 1111 1076 1075 1076 1075 1112 1112 1113 1114 1025 1025 1055 1055 1055 1055 1055 1055 1055 1055 1055 1055 1055 1055 1055 1055 1111 1076
1075 1110 118 119 1106 1075 1076 1075 1076 1109 3183 3184 1108 1109 1108 1105 1117 1118 1106 1109 1108 1109 1108 1109 1076 1112 1112 1112 1112 1112 1112 1112 1112 1112 1112 1112 1112 1112 1112 1112 1112 1112 1112 1106 1107
1104 1105 118 119 1111 1076 1075 1076 1075 1110 3185 3186 1111 1108 1075 1076 1075 1076 1075 1076 1075 1076 1075 1108 1109 1108 1109 1108 1109 1108 1109 1108 1109 1108 1109 1108 1109 1108 1109 1108 1109 1108 1109 1108 1109
1075 1110 118 119 1106 1075 1076 1075 1076 1105 3183 3184 0 0 0 0 0 0 0 0 1106 1109 1108 1075 1076 1075 1076 1075 1076 1075 1104 1105 0 0 0 0 0 0 0 0 1106 1075 1076 1075 1076
1104 1105 118 119 1111 1108 1109 1108 1109 1110 3111 3112 12288 0 0 0 0 0 0 0 12327 40 41 42 41 42 41 42 41 42 39 12328 0 0 0 0 0 0 0 0 1111 1110 1115 1116 1111
1075 1110 118 119 1106 1109 1076 1075 1104 1105 3117 3118 12288 0 0 0 0 0 0 0 12333 46 47 48 47 48 47 48 47 48 45 12334 0 0 0 0 0 0 0 0 1106 1105 1117 1118 1106
1104 1105 118 119 1111 1110 1115 1116 1111 1108 1112 1112 1025 1025 1025 1025 1025 1025 1025 1025 1112 1112 1112 1112 1112 1112 1112 1112 1112 1112 1112 1112 1025 1025 1025 1025 1025 1025 1025 1025 1076 1108 1109 1108 1109
1075 1110 118 119 1106 1105 1117 1118 1106 1075 1104 1105 1112 1112 1112 1112 1112 1112 1112 1112 1106 1109 1076 1075 1076 1075 1076 1075 1076 1075 1104 1105 1112 1112 1112 1112 1112 1112 1112 1112 1109 1075 1076 1075 1076
1104 1105 118 119 1111 1108 1109 1108 1109 1076 1075 1076 1075 1076 1075 1076 1075 1076 1075 1076 1075 1110 1115 1116 1111 1076 1075 1076 1075 1108 1109 1076 1075 1076 1075 1076 1075 1076 1075 1076 1075 1108 1109 1108 1109
1075 1110 118 119 1106 1109 1076 1075 1076 1075 1076 1075 1076 1075 1076 1075 1076 1075 1076 1075 1076 1105 1117 1118 1106 1075 1076 1075 0 10240 128 129 129 129 129 130 10240 0 1076 1075 1076 1075 1076 1075 1076
1104 1105 118 119 1111 1108 1075 1108 1075 1076 51 52 51 1076 51 52 51 1076 1075 1076 1075 1076 1075 1108 1075 1076 1105 0 0 10240 0 0 0 0 0 0 10240 0 0 1106 1075 1076 1075 1108 1109
1075 1110 118 119 1106 1075 1108 1075 1110 1119 1120 53 1121 1122 1120 53 1121 1123 1106 1075 1110 0 0 0 0 0 0 0 0 10240 0 0 0 0 0 0 10240 0 0 0 0 0 1106 1075 1076
1104 1105 118 119 1111 1108 1075 1108 1105 1124 1125 54 1126 1127 1125 54 1126 1128 1111 1108 1105 0 0 0 0 0 0 0 0 10240 0 0 0 0 0 0 10240 0 0 0 0 0 1111 1108 1109
1075 1110 118 119 1106 1075 1108 1075 1110 1129 1130 55 1131 1129 1130 55 1131 1129 1106 1075 1110 0 0 0 0 0 0 0 0 0 0 0 0 0 0 0 0 0 0 0 0 0 1106 1075 1076
1104 1105 118 119 1111 1110 0 0 0 0 56 57 56 0 56 57 56 0 0 0 0 0 0 0 0 0 0 0 0 0 0 0 0 0 0 0 0 0 0 0 0 0 1111 1108 1109
1075 1110 118 119 1106 1105 0 0 0 0 0 0 0 0 0 0 0 0 0 0 0 0 0 0 0 0 0 0 0 58 59 60 61 62 0 0 63 64 65 0 0 0 1106 1075 1076
1104 1105 118 119 1111 1110 0 0 0 0 0 0 0 0 0 0 0 0 0 0 0 0 0 0 0 0 0 0 0 66 67 68 69 70 0 0 71 56 72 0 0 0 1111 1108 1109
1075 1110 118 119 1106 1105 32 33 0 0 0 0 0 0 0 0 0 0 0 0 0 0 0 0 0 0 0 0 0 73 74 75 76 0 0 0 77 78 79 131 0 0 1106 1075 1076
1104 1105 118 119 1111 1110 4128 4129 1025 1025 1025 1025 1025 1025 1025 1025 1025 1025 1025 1025 1025 1025 0 0 0 0 1025 1025 1025 1025 1025 1025 1025 1025 0 0 1025 1025 1025 1025 1025 1025 1111 1108 1109
1075 1110 118 119 1106 1105 3104 3105 1112 1112 1112 1112 1112 1112 1112 1112 1112 1112 1112 1112 1112 1112 20516 20516 20516 20516 1112 1112 1112 1112 1112 1112 1112 1112 20516 20516 1112 1112 1112 1112 1112 1112 1076 1075 1076
1104 1105 118 119 1111 1110 3104 3105 1106 1075 1110 1115 1116 1111 1110 1115 1116 1111 1108 1109 1108 1109 1108 1109 1108 1109 1108 1105 0 0 132 0 0 0 1132 1108 1109 1108 1109 1110 1115 1116 1111 1108 1109
1075 1110 118 119 1106 1105 3104 3105 1111 1108 1105 1117 1118 1106 1105 1117 1118 1106 1075 1076 1075 1076 1075 1076 1075 1108 1109 1110 0 0 132 0 0 0 1133 1134 1108 1109 1108 1105 1117 1118 1106 1075 1076
1104 1105 118 119 1111 1110 3104 3105 1106 1075 1108 1109 1108 1109 1108 1109 1108 1109 1108 1109 1108 1109 1108 1109 1108 1109 1108 1105 0 133 134 135 0 0 1132 1108 1109 1110 136 137 138 139 1111 1108 1109
1075 1110 118 119 0 0 3104 3105 0 0 0 0 0 0 0 0 0 0 0 0 0 0 0 0 0 0 140 141 142 143 144 145 146 0 0 0 0 0 147 148 148 149 1106 1075 1076
1104 1105 118 119 0 0 3104 3105 0 0 0 0 0 0 0 0 0 0 0 0 0 0 0 0 0 0 150 151 152 153 7 8 154 0 0 0 0 0 155 156 157 158 1111 1108 1109
1075 1110 118 119 0 0 3104 3105 0 0 0 0 0 0 0 0 0 0 0 0 0 0 0 0 0 0 159 160 161 162 9 10 163 0 0 0 0 0 164 165 166 167 1106 1075 1076
1104 1105 118 119 1025 1025 1025 1025 1025 1025 1025 1025 1025 1025 1025 1025 1025 1025 1025 1025 1025 1025 1025 1025 1025 1025 1025 1025 1025 1025 1025 1025 1025 1025 1025 1025 1025 1025 1025 1025 1025 1025 1111 1108 1109
1075 1110 20517 20518 1112 1112 1112 1112 1112 1112 1112 1112 1112 1112 1112 1112 1112 1112 1112 1112 1112 1112 1112 1112 1112 1112 1112 1112 1112 1112 1112 1112 1112 1112 1112 1112 1112 1112 1112 1112 1112 1112 1106 1075 1108
1104 1105 1025 1025 1111 1076 1075 1076 1075 1076 1075 1076 1075 1076 1075 1076 1075 1076 1075 1076 1075 1076 1075 1076 1075 1076 1075 1076 1075 1076 1075 1076 1075 1076 1075 1076 1075 1076 1075 1076 1075 1076 1075 1076 1075
