50 79
1101 1077 1078 1102 1078 1102 1078 1102 1078 1102 1078 1102 1078 1102 1078 1102 1078 1102 1078 1102 1078 1102 1103 1104 1105 1077 1078 1102 1078 1102 1078 1102 1078 1102 1078 1102 1078 1102 1078 1102 1078 1102 1078 1102 1078 1102 1078 1102 1078 1106
1107 1058 0 0 0 0 0 0 0 0 0 0 0 0 17 0 0 0 0 0 18 19 1059 1108 1109 1058 0 0 0 3081 3082 0 0 0 0 3081 3082 0 0 0 0 3081 3082 0 0 0 0 0 0 1079
1110 1046 0 0 0 0 0 0 0 0 0 0 0 20 21 0 0 0 0 0 0 0 1079 1111 1112 22 0 0 0 3081 3082 0 0 0 0 3081 3082 0 0 0 0 3081 3082 0 0 0 0 0 0 1059
1113 1058 0 0 0 0 0 0 0 0 0 23 24 25 26 27 28 0 0 0 0 0 1059 1114 1115 29 24 30 0 3081 3082 0 0 0 0 3081 3082 0 0 0 0 3081 3082 0 0 0 0 0 0 1079
1116 1046 0 0 0 0 0 0 0 0 0 1117 1118 1119 1118 1119 1120 0 0 0 1121 1122 1123 1107 1110 1124 1118 1125 0 3081 3082 0 0 0 0 3081 3082 0 0 0 0 3081 3082 0 0 0 0 0 0 1059
1126 1058 0 0 0 0 0 0 0 0 0 1127 1082 1128 1082 1128 1129 0 0 0 0 1118 1130 1110 1104 1105 1082 1131 0 3081 3082 0 0 0 0 3081 3082 0 0 0 0 3081 3082 0 0 0 31 0 0 1079
1110 1046 347 0 0 0 0 0 0 0 0 1059 1101 1107 1101 1107 1053 348 0 0 349 32 1103 1132 1133 1109 1110 1134 0 3081 3082 0 0 0 0 0 0 0 0 0 0 3081 3082 0 0 0 1135 4105 4106 1059
1136 1058 0 0 0 0 0 0 0 0 0 1079 1113 1137 1138 1105 1139 20492 348 0 0 350 33 1103 1107 1140 1141 1058 0 3081 3082 0 0 0 0 0 0 0 0 0 0 0 0 0 0 0 1142 3081 3082 1079
1143 1046 1144 21504 21504 21504 21504 1145 1146 1146 1147 1059 1148 1149 1150 1109 1151 1152 20492 348 0 0 0 33 1103 1153 1154 1134 0 3081 3082 0 0 0 0 0 0 0 0 0 0 0 0 0 0 0 1155 3081 3082 1059
1156 1058 0 0 0 0 0 0 0 0 0 1079 1113 1101 1107 1140 1107 1157 1152 20492 348 0 0 0 33 1103 1158 1058 0 3081 3082 0 0 0 0 0 0 0 0 0 0 0 0 0 0 0 1159 3081 3082 1079
1160 1046 0 0 0 0 0 0 0 0 0 1059 1101 1107 1110 1107 1101 1107 1157 1152 20492 348 0 0 0 1161 1162 1134 0 0 0 0 0 0 0 0 0 0 0 0 0 0 0 0 0 0 1155 3081 3082 1059
1107 1058 1163 1164 1164 1165 0 0 0 0 0 1079 1136 1110 1111 1112 1107 1140 1107 1157 1152 20492 0 0 0 1079 1141 34 0 0 0 0 0 0 0 0 0 0 0 0 0 0 0 0 0 0 1159 3081 3082 1079
1101 1046 0 0 0 0 0 0 0 0 0 35 1110 1107 1114 1115 1110 1107 1110 1107 1157 1166 351 0 0 1161 1167 36 27 24 27 24 27 24 27 24 30 0 0 0 0 0 0 0 0 0 1155 3081 3082 1059
1113 1058 0 0 0 0 0 23 24 27 24 37 1138 1105 1107 1116 1168 1101 1107 1110 1107 1169 0 0 0 1079 1170 1171 1119 1118 1119 1118 1119 1118 1119 1118 1125 352 352 352 352 352 352 352 352 352 1159 3081 3082 1079
1137 1046 0 0 0 0 0 1117 1118 1119 1118 1130 1150 1109 1110 1170 1172 1104 1105 1104 1105 1134 0 0 0 1161 1173 1174 1128 1082 1128 1082 1128 1082 1128 1082 1175 20493 20493 20493 20493 20493 20493 20493 20493 20493 1176 3081 3082 1059
1149 1058 0 0 0 0 0 1127 1082 1128 1082 1110 1107 1140 1113 1177 1107 1108 1109 1108 1109 1058 0 0 0 1079 1178 1143 1107 1173 1111 1112 1179 1116 1180 1101 1181 1118 1119 1118 1119 1118 1119 1118 1119 1118 1182 3081 3082 1079
1183 1046 0 0 0 17 0 33 1042 1043 1078 1071 1103 1107 1101 1184 1110 1107 1140 1113 1110 1077 0 0 0 33 1103 1185 1101 1185 1114 1115 1101 1170 1186 1107 1101 1082 1128 1082 1128 1082 1128 1082 1128 1187 38 3081 3082 1059
1188 34 0 0 20 21 0 0 0 0 0 0 33 1103 1077 1078 1071 1078 1071 1078 1077 38 0 0 0 0 33 1078 1102 1078 1107 1101 1077 39 40 39 40 1078 1102 1078 1102 1078 1102 1078 1102 38 0 3081 3082 1079
1189 36 27 24 25 26 27 24 0 0 353 0 0 33 38 0 0 0 0 0 0 0 0 0 0 0 0 17 0 0 41 1190 38 0 0 17 1042 1043 0 0 0 0 0 0 0 0 0 0 0 1059
1136 1171 1119 1118 1119 1118 1119 1118 1121 1122 49496 353 0 30 0 0 20 0 0 0 0 0 0 0 0 0 0 21 0 0 0 30 0 0 0 21 0 0 0 0 0 0 0 0 0 0 27 0 0 1079
1191 1192 1128 1082 1128 1082 1128 1193 1118 1119 1194 49497 27 1195 27 24 25 24 30 0 0 0 0 24 27 24 27 26 27 24 27 1195 27 24 27 26 0 0 27 24 27 24 27 24 27 50522 1119 0 0 1059
1196 1101 1107 1197 1107 1101 1107 1197 1082 1128 1198 1194 1119 1199 1119 1118 1119 1118 1125 5131 5131 5131 5131 1118 1119 1118 1119 1118 1119 1118 1119 1199 1119 1118 1119 1118 1121 1122 1119 1118 1119 1118 1119 1118 1119 1200 1144 21519 21519 1201
1191 1158 1202 1196 1191 1107 1110 1196 1191 1179 1203 1204 1205 1206 1128 1082 1128 1082 1131 0 0 0 0 1082 1128 1082 1128 1082 1128 1082 1128 1206 1128 1082 1128 1193 1118 1119 1207 1082 1128 1082 1128 1082 1128 1208 1128 1082 1128 1082
1196 1162 1184 1101 1196 1101 1184 1101 1209 1148 1196 1203 1210 1112 1107 1101 1211 1202 1212 0 0 0 0 1079 1213 1116 1168 1110 1136 1214 1077 1078 1102 1078 1102 1078 1187 1215 1216 1078 1102 1078 1102 1078 1102 1078 1102 1078 1102 1103
1202 1217 1218 1219 1112 1217 1220 1221 1162 1211 1222 1107 1114 1115 1202 1104 1223 1184 1058 0 0 0 0 1224 1225 1170 1226 1227 1143 1107 1058 0 0 0 0 0 0 0 0 0 0 0 0 0 0 0 0 0 0 1059
1184 1101 1107 1114 1115 1101 1228 1148 1229 1230 1231 1101 1107 1101 1184 1108 1109 1232 1212 0 0 0 0 1079 1233 1214 1136 1234 1156 1140 1212 0 0 0 0 0 0 0 0 0 0 0 0 0 0 0 0 0 0 1079
1110 1235 1101 1107 1101 1235 1173 1136 1236 1237 1183 1107 1101 1107 1232 1107 1238 1107 1058 0 0 0 0 1059 1239 1179 1202 1179 1160 1221 1058 0 0 0 0 0 0 0 0 1240 0 0 0 0 0 0 0 0 0 1059
1107 1241 1179 1191 1242 1243 1107 1177 1228 1225 1228 1230 1138 1105 1113 1191 1244 1245 1212 0 0 0 0 1079 1246 1101 1228 1230 1138 1105 1212 0 0 0 0 0 0 0 0 0 0 0 0 0 0 0 0 0 0 1079
1101 1246 1110 1136 1234 1156 1140 1184 1101 1247 1230 1231 1108 1248 1249 1250 1239 1179 1058 0 0 0 0 1059 1101 1219 1112 1196 1108 1251 1058 0 0 0 0 0 0 0 0 0 0 0 0 0 0 0 0 0 0 1059
1211 1101 1107 1202 1179 1160 1221 1232 1107 1101 1107 1183 1107 1101 1246 1252 1246 1101 1253 0 0 0 0 1079 1107 1114 1115 1101 1107 1101 1253 0 0 0 20 0 0 0 0 0 0 0 0 0 0 0 0 0 0 1079
1183 1077 1078 1254 1078 1255 1078 1071 1078 1071 1078 1071 1078 1071 1103 1184 1101 1077 38 0 0 0 0 33 1103 1077 42 43 44 40 38 0 0 31 25 28 0 0 0 0 0 0 0 0 0 0 0 0 0 1059
1184 1058 0 0 0 0 0 0 0 0 0 0 0 0 1059 1177 1077 38 0 0 0 0 0 0 1059 1058 0 0 0 0 0 0 17 1135 1119 1120 0 0 0 1256 0 0 0 0 0 0 0 0 0 1079
1257 1046 0 0 0 0 0 0 0 0 0 0 0 0 1079 1184 1058 0 0 0 0 0 0 0 1079 1212 0 0 0 0 0 0 21 45 1128 1129 0 0 0 0 0 0 0 0 1240 0 0 0 0 1059
1231 1058 0 0 0 0 0 0 0 0 0 0 0 0 1059 1232 1212 0 0 0 0 0 0 0 1092 1058 0 0 0 0 0 23 26 37 1107 1058 0 0 0 0 0 0 0 0 0 0 0 22528 22528 1079
1183 1046 0 0 0 20 0 0 0 0 0 0 0 0 1079 1211 1058 0 0 0 0 0 0 0 1079 1212 0 0 0 0 0 1117 1118 1130 1101 1212 0 0 0 0 0 0 0 0 0 0 0 0 0 1059
1258 1058 0 0 31 25 28 0 0 0 0 0 0 0 1059 1259 1260 0 0 0 0 0 0 0 1261 34 20 0 0 0 0 1127 1082 1202 1213 1058 0 0 0 0 0 0 0 0 0 0 0 0 0 1079
1101 1046 0 0 1135 1119 1120 0 0 0 0 0 0 0 1079 1246 1058 0 0 0 0 0 0 0 1079 36 25 28 0 0 0 33 1103 1246 1225 1212 0 0 0 0 0 0 0 0 0 0 0 0 0 1059
1213 1058 0 0 1069 1128 1129 0 0 0 0 0 0 0 1059 1189 1212 0 0 0 0 0 0 0 1059 1262 1119 1120 0 0 0 0 33 1103 1228 1058 0 4105 4106 0 0 0 0 0 1256 0 0 0 0 1079
1225 1046 0 0 1079 1107 1058 1042 1043 0 0 0 0 0 46 47 38 0 0 0 0 0 0 0 46 48 49 50 0 0 0 0 0 1263 1264 1265 0 3081 3082 0 0 0 0 0 0 0 0 0 0 1059
1231 1058 0 0 1059 1116 22 0 0 0 0 0 0 0 0 0 0 0 0 0 0 0 0 0 0 0 0 0 0 20 0 0 0 1079 1213 1058 0 3081 3082 0 0 0 0 0 0 0 0 0 0 1079
1266 1046 0 0 1079 1267 29 0 0 30 0 0 0 0 0 0 0 0 0 0 0 0 0 0 17 0 0 23 24 25 28 0 0 1224 1225 1212 0 3081 3082 0 0 0 5120 5120 0 0 0 0 0 1059
1268 1058 0 0 1059 1220 1269 1121 1122 1270 0 0 0 0 20 0 0 0 0 0 0 0 0 0 21 20 0 1271 1118 1119 1120 5131 5131 1079 1272 1058 0 3081 3082 0 0 0 0 0 0 0 0 0 0 1079
1101 1046 0 0 1079 1107 1273 1082 1128 1274 27 24 27 24 25 24 30 0 0 24 0 0 31 27 26 25 24 51 1082 1128 1129 0 0 1059 1275 1212 0 3081 3082 0 0 0 0 0 0 33110 33111 0 0 1059
1107 1058 0 0 1059 1220 1107 1101 1107 1276 1119 1118 1119 1118 1119 1118 1125 0 0 1118 5131 5131 1277 1119 1118 1119 1118 1278 1197 1237 1058 0 0 1079 1107 1058 0 3081 3082 0 33110 33111 0 0 0 3081 3082 0 0 1079
1202 1279 0 0 1079 1280 1112 1107 1220 1281 1128 1082 1128 1082 1128 1082 1282 22528 22544 1283 0 0 1284 1128 1082 1128 1082 1101 1285 1225 1286 0 0 1059 1177 1265 0 3081 3082 0 3081 3082 0 0 0 3081 3082 0 0 1059
1287 1058 0 0 1059 1114 1115 1101 1107 1101 1107 1101 1107 1101 1107 1101 1281 1128 1288 52 0 0 354 33 1103 1217 1197 1111 1112 1247 1058 0 0 1079 1184 1058 0 3081 3082 0 3081 3082 0 0 0 3081 3082 0 0 1079
1162 1046 0 0 1079 1107 1110 1136 1234 1156 1140 1280 1112 1107 1202 1107 1289 1179 1053 348 0 0 0 0 33 1103 1285 1114 1115 1290 1253 0 0 1059 1197 1212 0 3081 3082 0 3081 3082 0 0 0 3081 3082 0 0 1059
1107 1058 0 0 1059 1116 1168 1110 1136 1214 1221 1114 1115 1101 1184 1101 1209 1148 1139 20492 348 0 0 0 0 33 1103 1107 1197 1217 1058 0 0 1079 1285 1058 0 0 0 0 3081 3082 0 0 0 0 0 0 0 1079
1259 1046 0 0 1079 1126 1226 1227 1143 1107 1105 1107 1101 1248 1220 1221 1162 1211 1291 1152 20492 348 0 0 0 0 33 1103 1292 1290 1212 0 0 1059 1148 1293 0 0 0 0 0 0 0 0 0 0 0 0 0 1059
1136 1058 0 0 1059 1110 1136 1234 1156 1140 1248 1101 1107 1220 1228 1148 1229 1294 1107 1157 1152 20492 348 0 0 0 0 33 1103 1158 1058 0 0 1079 1211 1058 0 0 0 0 0 0 0 0 0 0 0 0 0 1079
1202 1046 0 0 1295 53 54 47 54 47 54 47 54 47 1078 1071 1103 1211 1116 1180 1157 1152 20492 348 0 0 0 0 1059 1162 1253 0 0 1059 1290 1293 0 17 0 0 0 0 0 17 0 0 0 1042 1043 1059
1184 1058 0 0 1296 38 0 0 0 0 0 0 0 0 1042 1043 1059 1230 1267 1297 1107 1157 1152 20492 355 0 0 0 1079 1229 1058 0 0 1079 1196 34 0 21 0 0 20 0 0 21 20 0 0 0 0 1079
1259 1298 0 0 1155 0 0 0 0 0 0 0 0 0 0 0 55 1209 1220 1219 1112 1107 1157 1166 356 0 0 0 1299 1300 1260 0 0 1261 1222 36 27 26 27 24 25 24 27 26 25 24 30 0 0 1059
1246 1058 0 0 1301 0 0 0 0 0 0 0 0 357 0 0 56 1162 1211 1114 1115 1101 1077 57 356 0 0 0 1079 1302 1058 0 0 1079 1196 1171 1119 1118 1119 1118 1119 1118 1119 1118 1119 1118 1125 1121 1122 1123
1202 1046 0 0 1155 0 0 0 0 0 0 0 0 1117 1121 1122 1303 1229 1230 1196 1101 1077 38 0 0 0 0 352 1080 1108 1253 0 0 33 1103 1192 1128 1082 1128 58 1128 1082 1128 1082 1128 1082 1304 1119 1118 1130
1184 1058 0 0 1301 0 0 0 0 0 0 0 0 1127 1082 1128 1305 1306 1237 1257 1077 38 0 0 0 0 352 20494 1307 1107 1058 0 0 0 33 1103 1132 1308 1179 1101 1258 1259 1107 1101 1107 1197 1309 1128 1082 1310
1232 1311 0 0 1155 0 0 0 0 0 0 0 0 33 1103 1107 1312 1313 1225 1314 38 0 0 0 0 352 20494 1200 1315 1101 1212 0 0 0 0 33 1078 1316 1078 1317 1078 1317 1078 1317 1078 1285 1318 1077 1078 1319
1136 1058 0 0 1301 0 0 0 0 0 0 0 0 0 33 1103 1320 1220 1077 38 0 0 0 0 352 20494 1200 1208 1101 1107 1058 0 0 0 0 17 0 0 0 0 0 0 0 0 0 1070 1321 59 60 61
1322 1046 0 0 1155 0 0 0 0 0 0 0 0 0 0 33 1103 1077 38 0 0 0 0 352 20494 1200 1208 1101 1219 1112 1253 0 0 0 0 21 20 0 0 0 0 0 0 0 0 0 30 347 62 63
1184 1058 0 0 1301 0 0 0 0 0 0 0 0 0 0 0 1059 1058 0 0 0 0 352 20494 1200 1208 1101 1158 1114 1115 1058 0 0 24 27 26 25 24 27 24 30 9 10 23 24 27 1195 64 65 66
1232 1046 0 0 1155 0 0 0 0 0 0 0 0 0 0 0 1079 1212 0 0 0 0 20494 1200 1208 1290 1211 1162 1107 1202 1260 0 0 1118 1119 1118 1119 1118 1119 1118 1125 4105 4106 1117 1118 1119 1199 1119 1118 1119
1107 1058 0 0 1301 0 0 0 0 0 0 0 0 0 0 0 1299 1058 0 0 0 350 1323 1208 1290 1324 1290 1229 1101 1325 1058 0 0 1082 1128 1082 1128 1082 1128 1082 1131 3081 3082 1127 1082 1128 1206 1128 1082 1128
1112 1046 0 0 1155 0 0 0 0 0 0 0 0 0 0 0 1079 1326 0 0 0 0 67 1103 1136 1327 1292 1101 1184 1290 1253 0 0 1079 1179 1197 1211 1312 1328 1259 1134 3081 3082 33 1103 1107 1197 1136 1259 1107
1115 1058 0 0 1159 0 0 0 0 0 0 0 0 0 0 0 1261 1058 0 0 0 0 0 33 1103 1329 1105 1330 1220 1331 1058 22528 22528 1332 1232 1333 1078 1334 1078 1102 38 3081 3082 0 33 1078 1319 1078 1317 1103
1101 1046 0 0 358 0 0 17 0 0 0 0 0 17 0 17 1079 1095 0 0 0 0 0 0 33 1103 1335 1252 1336 1101 1212 352 352 1079 1136 1058 0 0 0 0 0 3081 3082 17 0 0 0 0 0 1059
1107 1058 0 0 0 0 0 21 20 0 0 0 0 21 0 21 68 1058 0 0 0 0 0 0 0 33 1337 69 70 1136 1053 20493 20493 1080 1259 71 0 0 0 0 20 3081 3082 21 0 0 0 0 0 1079
1101 1046 0 0 23 24 27 26 25 24 27 24 27 26 27 26 37 1212 0 0 0 0 0 0 0 72 1211 73 73 1257 1124 1118 1119 1338 1339 34 9 10 23 24 25 3081 3082 26 28 28 0 0 0 1059
1258 1058 0 0 1117 1118 1119 1118 1119 1118 1119 1118 1119 1118 1119 1118 1130 1053 348 0 0 0 0 0 0 74 1340 73 73 1136 1257 1082 1128 1136 1341 1134 4105 4106 1117 1118 1119 1118 1119 1118 1119 1120 0 0 0 1079
1101 1046 0 0 1127 1082 1128 1082 1128 1082 1128 1082 1128 1082 1128 1082 1342 1139 20492 348 0 0 0 0 0 0 33 75 76 1078 1317 1078 1317 1078 1343 38 3081 3082 1127 1082 1128 1082 1128 1082 1128 1129 0 0 0 35
1107 1058 0 0 1059 1259 1107 1197 1211 1344 1331 1197 1107 1101 1107 1101 1107 1101 1152 20492 348 0 0 0 0 0 0 0 0 0 0 0 0 0 0 0 3081 3082 33 1103 1345 1189 1107 1116 1346 1058 0 0 24 37
1140 1046 0 0 1079 1104 1347 1285 1230 1138 1347 1285 1197 1219 1112 1113 1116 1346 1157 1152 20492 348 0 0 0 0 0 0 0 0 0 17 0 17 0 0 0 0 0 33 1348 1136 1189 1349 1186 1212 0 0 1118 1130
1107 1058 0 0 1059 1108 1219 1112 1107 1108 1136 1232 1285 1114 1115 1101 1126 1226 1107 1157 1152 20492 348 0 0 0 0 0 20 0 0 21 0 21 20 0 0 0 0 0 33 1103 1219 1112 1113 1058 0 0 1082 1186
1112 1046 0 0 1079 1107 1114 1115 1101 1107 1259 1107 1101 1107 1101 1209 1110 1136 1101 1107 1157 1152 20492 348 0 24 27 24 25 24 27 26 27 26 25 28 0 0 0 0 0 1059 1114 1115 1189 1134 0 0 46 1113
1115 1058 22528 22528 1059 1259 1107 1197 1107 1350 1285 1101 1107 1350 1107 1162 1107 1197 1107 1110 1107 1157 1152 20492 348 1118 1119 1118 1119 1118 1119 1118 1119 1118 1119 1120 0 0 24 27 24 1061 1077 1078 1102 38 0 0 0 55
1294 1311 352 352 1079 1107 1351 1168 1173 1109 1352 1248 1220 1221 1101 1229 1232 1285 1197 1113 1245 1107 1157 1152 20492 1353 1128 1082 1128 1082 1128 1082 1128 1082 1128 1129 0 0 1118 1119 1118 1354 38 0 1355 0 0 0 0 1059
1258 1053 20493 20493 1080 1101 1126 1226 1227 1143 1136 1101 1228 1197 1107 1140 1107 1101 1356 1105 1357 1218 1158 1157 1152 1358 1107 1101 1107 1101 1107 1101 1107 1110 1211 1053 22552 22555 1353 1128 1082 359 360 0 0 0 0 0 20 55
1101 1124 1118 1119 1359 1237 1110 1136 1360 1156 1202 1107 1310 1285 1101 1107 1101 1107 1108 1109 1294 1244 1162 1107 1361 1107 1116 1362 1222 1219 1112 1107 1110 1113 1290 1124 1118 1119 1359 1107 1053 24 27 24 1051 24 27 24 25 56
1107 1312 1082 1128 1363 1364 1179 1101 1107 1202 1213 1232 1285 1116 1180 1101 1107 1140 1107 1197 1107 1197 1211 1222 1107 1140 1365 1294 1244 1114 1115 1110 1211 1101 1184 1101 1082 1128 1363 1140 1124 1118 1119 1118 1119 1118 1119 1118 1119 1359
1259 1107 1101 1258 1350 1246 1101 1107 1101 1246 1225 1107 1101 1126 1226 1107 1232 1196 1101 1196 1101 1196 1294 1196 1140 1107 1162 1107 1101 1107 1101 1107 1140 1248 1232 1211 1222 1107 1101 1184 1101 1082 1128 1082 1128 1082 1128 1082 1128 1363
