88 59
1041 1041 1041 1041 1041 1041 1041 1041 1041 17 17 1041 1041 1041 1041 17 17 1041 1041 1041 1041 1041 1041 1041 1041 1041 1041 1041 1041 1041 1041 1041 1041 1041 1041 1041 1041 1041 1041 1041 1041 1041 1041 1041 1041 1041 1041 1041 1041 1041 1041 1041 1041 1041 1041 1041 1041 1041 1041 1041 1041 1041 1041 1041 1041 1041 1041 1041 1041 1041 1041 1041 1041 1041 1041 1041 1041 1041 1041 1041 1041 1041 1041 1041 1041 1041 1041 1041
1041 1043 1064 1064 1064 1064 1055 1054 1053 18 19 1055 1054 1053 1055 18 19 1054 1053 1054 1053 1055 1055 1055 1042 1041 1041 1041 1041 1041 1041 1065 1066 1041 1041 1041 1067 1041 1041 1041 1041 1041 1041 1067 1041 1041 1041 1041 1041 1041 1041 1041 1041 1065 1066 1041 1041 1041 1041 1068 1069 1070 1041 1067 1041 1041 1041 1041 1041 1041 1041 1041 1041 1041 1065 1066 1041 1041 1041 1041 1041 1041 1041 1041 1068 1069 1070 1041
1041 1047 20491 20491 20491 20491 0 20 21 22 23 0 20 21 0 22 23 20 21 20 21 0 0 0 1046 1041 1041 1041 1041 1041 1041 1071 1072 1041 1065 1066 1041 1041 1041 1041 1041 1065 1066 1041 1041 1041 1041 1041 1041 1041 1073 1074 1075 1071 1072 1041 1041 1041 1041 1076 1077 1078 1041 1041 1041 1041 1041 1041 1041 1041 1041 1067 1041 1041 1071 1072 1041 1041 1041 1041 1041 1041 1041 1041 1076 1077 1078 1041
1041 1047 119 119 119 119 0 0 0 24 25 0 0 0 0 24 25 0 0 0 0 26 27 28 1046 1067 1041 1041 1041 1041 1041 1041 1041 1041 1071 1072 1041 1041 1041 1041 1041 1071 1072 1041 1041 1041 1041 1041 1041 1041 1079 1041 1080 1041 1041 1041 1041 1041 1041 1081 1082 1083 1041 1041 1041 1041 1041 1065 1066 1041 1041 1041 1041 1041 1041 1041 1041 1041 1041 1041 1041 1041 1041 1041 1081 1082 1083 1041
1041 1047 0 0 0 0 0 0 0 0 0 0 0 0 0 0 0 0 0 0 0 1084 1085 1086 1087 1041 1073 1074 1075 1041 1041 1041 1041 1041 1041 1041 1041 1041 1041 1041 1041 1041 1041 1041 1041 1041 1041 1041 1041 1041 1088 1089 1090 1041 1041 1041 1041 1041 1041 1091 1092 1093 1041 1041 1067 1041 1041 1071 1072 1041 1041 1041 1041 1041 1041 1041 1041 1041 1041 1041 1065 1066 1041 1041 1091 1092 1093 1041
1041 1047 0 0 0 0 0 0 0 0 0 0 0 0 0 0 0 0 0 0 0 120 1041 1041 1041 1041 1079 1041 1080 1041 1041 1041 1041 1041 1041 1041 1041 1041 1041 1041 1041 1041 1041 1041 1041 1041 1041 1041 1041 1041 1041 1041 1041 1041 1041 1041 1041 1041 1041 1041 1041 1041 1041 1041 1041 1041 1041 1041 1041 1041 1041 1041 1041 1041 1041 1041 1041 1067 1041 1041 1071 1072 1041 1041 1041 1041 1041 1041
1041 1047 0 0 0 0 26 27 27 0 0 0 0 0 0 0 0 0 0 0 0 1046 1041 1041 1041 1041 1088 1089 1090 1041 1041 1041 1041 1041 1041 1041 1041 1041 1041 1041 1041 1041 1041 1041 1041 1041 1067 1041 1041 1041 1041 1041 1041 1041 1067 1041 1041 1041 1041 1041 1041 1041 1041 1041 1041 1041 1041 1053 1054 1041 1067 1053 1054 1067 1041 1041 1041 1041 1041 1041 1041 1041 1041 1041 1041 1041 1041 1041
1041 1047 0 0 26 28 1084 1085 1085 1094 1095 1095 1095 1095 1095 1095 1096 0 0 0 0 1046 1041 1041 1041 1041 1041 1041 1041 1041 1041 1041 1041 1041 1041 1041 1041 1041 1041 1041 1065 1066 1041 1041 1041 1041 1041 1041 1041 1041 1041 1041 1065 1066 1041 1041 1041 1041 1041 1041 1065 1066 1041 1041 1041 1067 29 21 20 30 29 21 20 1055 1055 1055 1055 1054 1041 1067 1053 1054 1041 1041 1041 1041 1041 1041
1041 1047 0 0 1084 1086 1097 1098 1098 1098 1098 1098 1087 1098 1098 1098 1099 21504 21504 21504 21504 121 1055 1055 1042 1041 1041 1041 1041 1041 1041 1041 1041 1041 1041 1041 1041 1067 1041 1041 1071 1072 1041 1041 1041 1041 1041 1041 1041 1041 1041 1041 1071 1072 1041 1041 1041 1067 1041 1041 1071 1072 1041 1043 31 31 21 0 122 20 21 122 0 0 0 0 0 20 30 29 21 20 31 31 1042 1041 1041 1041
1041 1047 0 0 1100 1101 1046 1041 1041 1041 1041 1041 1041 1041 1041 1041 1047 0 0 0 0 0 0 0 1046 1041 1041 1041 1041 1041 1041 1041 1041 1041 1041 1065 1066 1041 1041 1041 1041 1041 1041 1041 1041 1041 1041 1041 1041 1041 1041 1041 1041 1067 1041 1041 1041 1041 1041 1041 1041 1041 1041 1047 1102 1103 0 0 0 0 0 0 0 0 0 0 0 122 20 21 122 0 0 0 1046 1041 1041 1041
1041 1047 0 0 20491 20491 1046 1041 1041 1041 1053 1055 1055 1054 1053 1055 1049 0 0 0 0 32 27 28 1046 1041 1041 1041 1073 1074 1075 1041 1041 1041 1041 1071 1072 1041 1041 1041 1041 1041 1041 1041 1041 1041 1041 1041 1041 1041 1041 1041 1041 1041 1041 1041 1041 1041 1041 1041 1041 1041 1041 1047 0 0 0 0 0 0 0 0 0 0 0 0 0 0 0 0 0 0 0 0 1046 1041 1041 1041
1041 1047 0 0 119 119 1046 1041 1041 1053 21 0 0 20 21 0 0 0 0 0 32 50290 1085 1086 1087 1041 1065 1066 1079 1041 1080 1041 1041 1041 1041 1041 1041 1041 1041 1041 1041 1041 1041 1041 1041 1041 1041 1041 1041 1041 1041 1041 1041 1041 1041 1041 1041 1041 1041 1068 1069 1070 1041 1047 0 0 27 27 27 27 27 27 27 28 10240 10240 26 27 27 27 27 27 27 28 1046 1041 1041 1041
1041 1047 0 0 0 0 1048 1055 1042 1047 0 0 0 0 0 0 0 0 0 32 50290 1104 1105 1041 1041 1041 1071 1072 1088 1089 1090 1041 1041 1041 1041 1041 1041 1041 1041 1041 1041 1041 1073 1074 1075 1041 1041 1041 1041 1041 1041 1041 1041 1041 1067 1041 1041 1041 1041 1076 1077 1078 1041 1106 1107 1108 1085 1085 1085 1085 1085 1085 1085 1086 0 0 1084 1085 1085 1085 1085 1085 1085 1086 1109 1041 1041 1041
1041 1047 0 0 0 0 0 0 1048 1049 0 0 26 27 27 27 27 27 27 50290 1104 1041 1041 1041 1041 1053 1055 1055 1042 1041 1041 1041 1041 1041 1041 1067 1041 1041 1041 1041 1065 1066 1079 1041 1080 1041 1041 1041 1041 1041 1041 1041 1041 1041 1041 1041 1041 1041 1041 1081 1082 1083 1041 1043 1055 1055 1055 1054 1105 1105 1053 1055 1055 1049 0 0 1046 1105 1105 1105 1105 1105 1105 1041 1041 1041 1041 1041
1041 1047 0 0 0 0 4 0 0 0 5228 5228 1084 1085 1085 1085 1085 1085 1085 1104 1041 1041 1041 1041 29 21 0 0 1046 1043 32784 32784 1041 1053 1054 1041 1041 1053 1054 1041 1071 1072 1088 1089 1090 1041 1041 1041 1041 1041 1041 1041 1041 1041 1041 1041 1041 1041 1041 1091 1092 1093 1041 1047 0 0 0 20 1054 1053 21 0 0 0 0 0 1046 1041 1068 1069 1070 1041 1041 1041 1041 1041 1041 1041
1041 1047 0 0 0 0 5 27 1110 1111 0 0 1048 1055 1055 1055 1055 1055 1055 1055 1055 1055 1054 29 21 0 0 0 1048 1049 123 124 1053 21 20 30 29 21 20 1055 1055 1054 1041 1041 1041 1041 1041 1041 1041 1041 1041 1041 1041 1041 1041 1041 1041 1041 1041 1041 1041 1041 1041 1112 49264 122 0 122 20 21 122 0 0 0 0 0 1046 1041 1076 1077 1078 1041 1041 1067 1041 1041 1041 1041
1041 1047 0 0 0 0 1113 1085 1087 1047 0 0 0 0 0 0 0 0 0 0 0 0 20 21 0 0 0 0 0 0 11273 11274 21 0 122 20 21 122 0 0 0 20 1042 1041 1041 1041 1041 1041 1041 1041 1041 1041 1041 1041 1041 1041 1041 1041 1041 1041 1041 1065 1066 1041 1112 49264 0 0 0 0 0 0 0 0 0 0 1046 1041 1081 1082 1083 1041 1041 1041 1041 1041 1041 1041
1041 1047 26 28 0 0 1110 1098 1087 1047 0 0 0 0 0 0 0 0 0 0 0 0 0 0 0 32 27 27 1110 1111 0 0 0 0 0 0 0 0 0 0 0 0 1046 1041 1041 1067 1041 1041 1041 1041 1041 1041 1041 1041 1073 1074 1075 1041 1041 1041 1041 1071 1072 1041 1053 21 0 0 0 0 0 0 125 125 0 0 1046 1041 1091 1092 1093 1041 1041 1041 1041 1041 1041 1041
1041 1047 1084 1086 0 0 1046 1041 1041 1047 0 0 0 0 0 0 0 0 0 0 0 0 0 0 32 50290 1085 1085 1109 1047 0 0 0 0 0 0 0 0 0 0 0 0 1046 1041 1041 1041 1041 1041 1041 1041 1041 1041 1041 1041 1079 1041 1080 1041 1041 1041 1041 1041 1041 1053 21 122 0 0 0 0 122 126 20492 20492 0 0 1046 1041 1041 1041 1041 1041 1041 1041 1041 1068 1069 1070
1041 1047 1100 1101 0 0 1046 1041 1041 1047 26 27 27 27 27 28 0 0 26 27 27 27 27 27 50290 1104 1105 1105 1053 1049 0 0 0 0 0 0 0 0 0 0 26 28 1046 1041 1041 1041 1041 1041 1041 1041 1041 1041 1041 1041 1088 1089 1090 1041 1041 1041 1041 1041 1053 21 0 0 0 0 0 0 127 20493 20494 1114 0 0 1046 1041 1041 1041 1041 1065 1066 1041 1041 1076 1077 1078
1041 1047 20491 20491 0 0 1046 1041 1041 1106 1084 1085 1085 1085 1085 1086 5228 5228 1084 1085 1085 1085 1085 5181 1104 1041 1041 29 21 0 12288 0 0 0 0 0 0 0 0 0 1084 1086 1087 1041 1041 1041 1041 1041 1041 1041 1041 1041 1041 1041 1041 1041 1041 1041 1041 1041 1041 1041 1047 0 0 0 0 0 0 0 20493 1115 1041 1047 0 0 1046 1041 1041 1041 1041 1071 1072 1041 1041 1081 1082 1083
1041 1047 119 119 0 0 1048 1064 1064 1064 1064 1064 1064 1064 1064 1049 0 0 1048 1055 1055 1054 1053 32784 1055 1055 31 21 0 0 12288 0 0 0 0 0 0 0 0 0 1046 1041 1041 1041 1041 1041 1041 1067 1041 1041 1041 1041 1041 1041 1041 1041 1041 1041 1041 1041 1041 1041 1047 0 122 0 0 0 0 0 33 1041 1041 1047 0 0 1046 1041 1041 1041 1041 1041 1041 1041 1041 1091 1092 1093
1041 1047 0 0 0 0 0 20491 20491 20491 20491 20491 20491 20491 20491 0 0 0 0 0 0 20 21 32784 0 0 0 0 0 0 12288 0 0 0 0 0 0 0 0 0 1048 1055 1042 1041 1041 1041 1041 1041 1041 1065 1066 1041 1041 1041 1041 1041 1041 1041 1041 1041 1041 1041 1047 128 0 122 0 0 0 0 20 30 1041 1047 0 0 1046 1041 1041 1041 1041 1041 1041 1041 1041 1041 1041 1041
1041 1047 0 4 0 0 0 119 119 119 119 119 119 119 119 0 0 0 0 0 0 0 0 32784 0 0 0 0 32 27 12288 0 26 28 0 0 0 0 0 0 0 0 1046 1041 1041 1041 1041 1041 1041 1071 1072 1041 1041 1041 1041 1041 1041 1041 1041 1041 1041 1041 1106 20495 128 0 122 0 0 0 129 20 1055 1049 0 0 1048 1042 1041 1067 1041 1041 1041 1041 1041 1041 1041 1041
1041 1047 26 5 27 34 0 0 0 0 0 0 0 0 122 35 27 27 27 36 122 0 0 32784 0 0 0 32 50290 1085 12288 0 1084 1086 0 0 0 0 0 0 0 0 1046 1041 1041 1041 1041 1041 1041 1041 1041 1041 1041 1041 1041 1041 1041 1041 1041 1041 1041 1041 1041 20580 20495 128 0 122 0 0 0 0 1099 21504 21504 21504 21504 1116 1041 1041 1041 1041 1041 1041 1041 1041 1041 1041
1041 1106 1084 1113 1085 49265 27 27 37 27 27 27 27 27 54390 53365 1085 1085 1085 51315 52340 27 27 32784 27 37 27 50290 1104 1117 0 0 1046 1117 0 0 0 0 0 0 26 28 1046 1041 1041 1041 1041 1053 1054 1041 1041 1041 1041 1041 1041 1041 1041 1041 1041 1041 1041 1041 1041 1041 20580 20495 128 0 122 0 0 0 0 0 0 0 1110 1087 1041 1041 1041 1041 1041 1041 1041 1041 1041 1041
1041 1041 1041 1041 1105 130 1085 1085 1118 1085 1085 1085 1085 1085 1119 1120 1105 1105 1105 1121 1122 1085 1085 1123 1085 1118 1085 1104 1041 1117 0 0 1048 1049 0 0 0 0 0 0 1084 1086 1087 1041 1041 1041 1053 21 20 1054 1041 1041 1041 1041 1041 1041 1041 1041 1041 1041 1041 1041 1041 1041 1041 20580 20495 128 0 0 0 0 0 0 0 0 1046 1073 1055 1055 1055 1055 1054 1067 1041 1053 1075 1041
1041 1043 1055 1055 1055 1055 1055 1055 1055 1042 1043 1064 1064 1064 1064 1054 1041 1041 1053 1055 1055 1055 1055 1055 1054 1053 1055 1055 1055 1049 0 0 0 0 0 0 0 0 0 0 1048 1055 1055 1055 1054 1053 21 122 0 20 1055 1055 1055 1042 1041 1041 1041 1041 1041 1041 1041 1041 1041 1065 1066 1041 20580 20495 128 0 26 27 27 28 0 0 1046 1047 0 0 0 0 20 1054 1053 21 1046 1041
1041 1047 0 0 0 0 32784 0 0 1046 1047 20491 20491 20491 20491 20 1054 1053 21 0 0 0 0 0 20 21 0 0 0 0 0 0 0 0 0 0 0 0 0 0 0 0 0 0 20 21 0 0 0 0 0 0 0 32790 32785 1041 1041 1041 1041 1041 1041 1041 1041 1071 1072 1041 1041 20580 20495 128 1084 1085 1085 1086 0 0 1046 1047 0 0 0 0 122 20 21 122 1046 1041
1041 1047 0 0 0 0 32784 0 0 1046 1047 119 119 119 119 0 20 21 0 26 28 0 0 0 0 0 0 0 0 0 0 0 0 0 32 27 37 27 27 27 36 122 0 0 0 0 0 0 0 0 0 0 0 32790 32785 1041 1041 1041 1041 1041 1041 1041 1041 1041 1041 1041 1041 1041 20580 20495 1046 1105 1105 1047 0 0 1046 1047 26 28 0 0 0 0 0 0 1046 1041
1041 1047 0 0 0 26 32784 27 27 1046 1047 0 0 0 0 0 0 32 27 1084 1086 26 27 27 27 37 27 27 34 0 0 0 0 32 50290 1085 1118 1085 1085 1085 51315 52340 27 37 27 27 27 27 37 27 27 27 28 32790 32785 1041 1041 1041 1041 1067 1041 1041 1041 1041 1041 1041 1041 1041 1041 1124 1109 1073 1055 1049 0 0 1125 1088 1084 1086 0 0 0 0 0 0 1046 1041
1041 1047 0 0 0 1084 1123 1085 1085 1109 1047 0 0 0 0 0 32 50290 1085 1087 1106 1084 1085 1085 1085 1118 1085 1085 49265 28 0 0 26 50290 1104 1105 1126 1105 1105 1105 1121 1122 1085 1118 1085 1085 1085 1085 1118 1085 1085 1085 1086 1087 1041 1041 1041 1041 1041 1041 1041 1065 1066 1041 1041 1041 1041 1041 1041 1041 1041 1079 120 0 0 0 0 1054 1053 21 0 0 0 0 0 0 1046 1041
1041 1047 0 0 0 1048 1055 1055 1055 1055 1049 0 0 0 0 0 50290 1104 1041 1041 1041 1041 1041 1041 1041 1041 1041 1041 130 1086 0 0 1084 1104 1041 1041 1041 1041 1041 1041 1041 1041 1041 1041 1041 1041 1041 1041 1041 1041 1041 1041 1041 1041 1041 1041 1041 1041 1041 1041 1041 1071 1072 1041 1067 1041 1041 1041 1041 1041 1041 1088 1098 1111 0 0 0 20 21 122 0 32 27 28 0 0 1046 1041
1041 1047 0 0 0 0 0 0 0 0 0 0 0 0 0 0 1127 1041 1043 1055 1055 1055 1055 1055 1055 1054 1053 1055 1055 1049 0 0 1048 1055 1055 1054 1053 1055 1055 1055 1055 1055 1055 1055 1055 1054 1053 1055 1055 1055 1055 1042 1041 1041 1041 1041 1041 1041 1041 1041 1041 1041 1041 1041 1041 1041 1041 1041 1041 1041 1041 1041 1041 1047 0 0 0 0 0 0 32 50290 1085 1086 0 0 1046 1041
1041 1047 0 0 0 0 0 0 0 0 0 0 0 0 0 0 1046 1041 1047 0 0 0 0 0 0 20 21 0 0 0 0 0 0 0 0 20 21 0 0 0 0 0 0 0 0 20 21 0 0 1102 1103 1046 1041 1041 1041 1041 1041 1041 1041 1041 1041 1068 1069 1070 1041 1041 1041 1041 1041 1041 1041 1041 1041 1047 0 0 0 26 27 27 50290 1104 1105 1047 0 0 1046 1041
1041 1047 0 0 0 0 4 0 0 0 0 0 0 0 0 0 1046 1041 1047 0 0 0 0 0 0 0 0 0 0 0 10240 10240 0 0 0 0 0 0 32 27 37 27 27 27 36 122 0 0 0 0 0 1046 1041 1041 1041 1041 1041 1041 1041 1041 1041 1076 1077 1078 1041 1041 1041 1041 1041 1041 1041 1041 1041 1047 0 0 1128 1084 1085 1085 1104 1041 1041 1047 0 0 1046 1041
1041 1047 26 27 27 27 5 0 0 0 26 27 27 27 27 28 1046 1041 1047 0 0 0 0 26 27 27 27 37 27 28 0 0 26 27 28 0 0 26 50290 1085 1118 1085 1085 1085 51315 52340 37 27 27 0 0 1046 1041 1041 1041 1041 1041 1067 1041 1041 1041 1081 1082 1083 1041 1041 1041 1041 1041 1041 1041 1041 1041 1047 0 0 1110 1087 1105 1105 1041 1041 1041 1047 0 0 1046 1041
1041 1047 1084 1085 1085 1085 1113 0 0 0 1084 1085 1085 1085 1085 1086 1046 1041 1047 0 0 0 0 1084 1085 1085 1085 1118 1085 1086 0 0 1084 1085 1086 0 0 1084 1104 1105 1126 1105 1105 1105 1121 1122 1118 1085 1085 1107 1108 1087 1041 1041 1041 1041 1041 1041 1041 1041 1041 1091 1092 1093 1041 1041 1041 1041 1041 1041 1041 1041 1041 1047 0 0 1046 1041 1041 1041 1041 1041 1041 1047 0 0 1046 1041
1041 1047 1100 1064 1064 1064 1101 0 0 0 1100 1064 1064 1064 1064 1101 1046 1041 1047 0 0 0 0 1046 1105 1105 1105 1105 1105 1117 0 0 1046 1105 1117 0 0 1046 1041 1041 1041 1041 1041 1041 1041 1041 1105 1105 1105 1105 1105 1041 1041 1041 1041 1041 1041 1041 1041 1041 1041 1041 1041 1041 1041 1041 1041 1041 1041 1041 1041 1041 1041 1047 0 0 1046 1041 1041 1041 1041 1041 1041 1047 0 0 1046 1041
1041 1047 20491 20491 20491 20491 20491 5120 5120 5120 20491 20491 20491 20491 20491 20491 1046 1041 1047 0 0 22528 22528 1046 1041 1041 1041 1041 1041 1117 0 0 1046 1041 1106 1098 1098 1087 1041 1041 1041 1041 1041 1041 1041 1041 1041 1067 1041 1065 1066 1041 1041 1041 1041 1041 1067 1041 1073 1074 1075 1041 1041 1041 1065 1066 1041 1041 1041 1041 1041 1041 1041 1047 0 0 1046 1041 1041 1041 1041 1041 1041 1047 0 0 1046 1041
1041 1047 119 119 119 119 119 0 0 0 119 119 119 119 119 119 1046 1041 1047 0 0 0 0 1046 1041 1041 1041 1041 1041 1106 1098 1098 1087 1041 1041 1041 1041 1041 1041 1041 1041 1041 1041 1041 1041 1041 1041 1041 1041 1071 1072 1041 1067 1041 1041 1041 1041 1041 1079 1041 1080 1041 1041 1041 1071 1072 1041 1041 1041 1041 1041 1041 1041 1047 0 0 1048 1055 1055 1054 1053 1055 1055 1049 0 0 1046 1041
1041 1047 0 0 0 0 0 0 0 0 0 0 0 0 0 0 1046 1041 1047 0 0 0 0 1046 1043 38 1042 1041 1041 1041 1041 1041 1041 1041 1041 1041 1041 1041 1041 1041 1041 1041 1041 1041 1041 1041 1041 1041 1041 1041 1041 1041 1041 1041 1041 1041 1041 1041 1088 1089 1090 1041 1041 1041 1041 1041 1041 1041 1041 1041 1041 1041 1041 1047 0 0 0 0 122 20 21 122 0 0 0 0 1046 1041
1041 1047 0 0 0 0 0 0 26 28 0 0 0 0 26 27 1046 1041 1047 0 0 0 0 1048 1049 39 1129 1055 1055 1042 1041 1041 1041 1067 1041 1041 1041 1041 1041 1041 1041 1041 1041 1041 1041 1041 1041 1041 1041 1068 1069 1070 1041 1041 1041 1041 1041 1041 1041 1041 1041 1041 1041 1041 1041 1041 1041 1041 1041 1041 1041 1041 1041 1047 0 0 0 0 0 0 0 0 0 0 0 0 1046 1041
1041 1047 0 0 0 0 0 0 1084 1086 0 0 0 0 1084 1085 1087 1041 1047 0 0 0 0 0 0 39 0 0 0 1046 1041 1041 1041 1041 1041 1065 1066 1041 1041 1041 1041 1041 1041 1041 1041 1041 1041 1041 1041 1076 1077 1078 1041 1041 1041 1041 1041 1067 1041 1041 1041 1041 1041 1041 1041 1041 1041 1041 1067 1041 1041 1041 1041 1047 0 0 26 27 27 27 27 27 27 28 0 0 1046 1041
1041 1047 0 0 0 0 0 0 1048 1049 0 0 0 0 1048 1055 1042 1041 1047 22528 22528 0 0 0 0 39 0 0 0 1046 1041 1041 1041 1041 1041 1071 1072 1041 1067 1041 1041 1041 1041 1041 1041 1067 1041 1041 1041 1081 1082 1083 1041 1041 1041 1041 1041 1068 1069 1070 1041 1041 1041 1041 1067 1041 1041 1041 1068 1069 1070 1073 1055 1130 0 0 1084 1085 1085 1085 1085 1085 1085 1086 0 0 1046 1041
1041 1047 0 0 0 0 0 0 0 0 0 0 0 0 0 0 1046 1041 1047 0 0 0 0 0 0 39 0 26 27 1046 1041 1041 1041 1041 1041 1041 1041 1041 1041 1041 1041 1041 1041 1041 1041 1041 1041 1041 1041 1091 1092 1093 1041 1041 1041 1041 1041 1076 1077 1078 1041 1041 1041 1041 1041 1041 1041 1041 1076 1077 1078 1047 1099 21504 21504 21504 21504 1116 1046 1105 1105 1105 1105 1047 0 0 1046 1041
1041 1047 4 0 0 0 0 0 0 0 0 0 0 0 0 4 1046 1041 1047 0 0 0 0 0 0 39 0 1084 1085 1087 1041 1041 1041 1041 1041 1068 1069 1070 1041 1041 1041 1041 1041 1041 1041 1041 1041 1041 1041 1041 1041 1041 1041 1041 1041 1041 1041 1081 1082 1083 1041 1041 1065 1066 1041 1041 1041 1041 1081 1082 1083 1088 1098 1111 0 0 1110 1098 1087 1067 1041 1041 1041 1047 0 0 1046 1041
1041 1047 5 28 0 0 0 26 27 27 27 27 27 27 27 5 1046 1041 1047 0 0 0 0 0 0 39 0 1048 1055 1042 1041 1041 1041 1041 1041 1076 1077 1078 1041 1041 1041 1041 1041 1041 1067 1041 1073 1074 1075 1041 1041 1041 1065 1066 1041 1041 1041 1091 1092 1093 1041 1041 1071 1072 1041 1041 1041 1041 1091 1092 1093 1041 1041 1047 0 0 1048 1042 1041 1068 1069 1070 1041 1047 0 0 1046 1041
1041 1047 1113 1086 0 0 0 1084 1085 1085 1085 1085 1085 1085 1085 1113 1087 1041 1047 0 0 22528 22528 0 0 39 0 0 0 1046 1041 1067 1041 1041 1041 1081 1082 1083 1041 1041 1041 1041 1041 1041 1041 1041 1079 1041 1080 1041 1041 1041 1071 1072 1041 1041 1041 1041 1041 1041 1041 1041 1041 1041 1041 1041 1041 1041 1041 1041 1041 1041 1041 1047 0 0 120 1046 1041 1076 1077 1078 1041 1047 22528 22528 1046 1041
1041 1047 1100 1101 0 0 0 1100 1064 1064 1064 1064 1064 1064 1064 1064 1042 1041 1047 0 0 0 0 0 0 39 0 0 0 1046 1041 1041 1041 1041 1041 1091 1092 1093 1041 1041 1041 1041 1041 1041 1041 1041 1088 1089 1090 1041 1041 1041 1041 1041 1041 1041 1041 1041 1041 1041 1041 1041 1041 1041 1041 1041 1041 1041 1041 1041 1041 1041 1041 1047 0 0 1110 1087 1041 1081 1082 1083 1041 1106 1098 1098 1087 1041
1041 1047 20491 20491 5120 5120 5120 20491 20491 20491 20491 20491 20491 20491 20491 20491 1046 1041 1047 0 0 0 0 0 0 39 0 0 0 1046 1041 1041 1041 1041 1041 1041 1041 1041 1041 1041 1041 1041 1041 1041 1041 1041 1041 1041 1041 1041 1041 1041 1041 1041 1041 1041 1041 1065 1066 1041 1041 1041 1041 1041 1041 1041 1041 1041 1065 1066 1041 1073 1055 1130 0 0 1048 1055 1042 1091 1092 1093 1041 1041 1041 1041 1041 1041
1041 1047 119 119 0 0 0 119 119 119 119 119 119 119 119 119 1048 1055 1049 0 0 0 0 0 0 39 0 0 0 1046 1067 1041 1073 1074 1075 1041 1041 1041 1065 1066 1041 1041 1041 1041 1041 1067 1041 1041 1041 1041 1041 1041 1041 1041 1041 1041 1041 1071 1072 1041 1041 1041 1041 1041 1041 1067 1041 1041 1071 1072 1041 1047 1099 21504 21504 21504 21504 1116 1048 131 132 133 134 1042 1041 1067 1041 1041
1041 1047 0 0 0 0 0 0 0 0 0 0 0 0 0 0 0 0 0 0 0 0 0 0 0 39 0 0 0 1046 1041 1041 1079 1041 1080 1041 1041 1041 1071 1072 1041 1041 1041 1041 1041 1068 1069 1070 1041 1041 1041 1041 1067 1041 1041 1041 1041 1041 1041 1041 1041 1041 1041 1041 1041 1041 1041 1041 1041 1041 1041 1088 1098 1111 0 0 0 0 0 135 136 136 137 1046 1041 1068 1069 1070
1041 1047 0 0 0 0 0 0 4 0 0 0 0 0 0 0 0 0 0 0 0 0 0 22528 22528 39 0 0 0 1046 1041 1041 1088 1089 1090 1041 1041 1041 1041 1041 1041 1041 1041 1041 1041 1076 1077 1078 1041 1041 1041 1041 1041 1041 1041 1041 1041 1041 1041 1041 1041 1041 1041 1041 1041 1041 1041 1041 1041 1041 1041 1041 1041 1047 0 0 0 0 0 138 139 140 141 1046 1041 1076 1077 1078
1041 1047 26 27 27 37 27 27 5 37 27 27 27 37 27 27 27 27 28 0 0 0 0 0 0 39 0 0 0 1046 1041 1041 1041 1041 1041 1041 1041 1041 1041 1041 1041 1041 1041 1041 1041 1081 1082 1083 1041 1041 1065 1066 1041 1041 1041 1041 1041 1041 1041 1041 1041 1041 1041 1041 1041 1041 1041 1041 1041 1041 1041 1041 1041 1047 0 0 26 27 27 142 143 144 145 1046 1041 1081 1082 1083
1041 1106 1084 1085 1085 1118 1085 1085 1113 1118 1085 1085 1085 1118 1085 1085 1085 1085 1086 19565 19565 19565 19565 19565 19565 19566 19565 19565 19565 1046 1041 1067 1041 1041 1041 1041 1041 1041 1041 1041 1041 1041 1041 1041 1041 1091 1092 1093 1041 1041 1071 1072 1041 1041 1041 1041 1041 1067 1041 1041 1041 1041 1041 1041 1041 1067 1041 1041 1067 1041 1041 1041 1041 1047 0 0 1084 1085 1085 1085 1085 1085 1085 1109 1041 1091 1092 1093
1041 1041 1041 1105 1105 1126 1105 1105 1126 1126 1105 1105 1105 1126 1105 1105 1105 1105 1117 19567 19567 19567 19567 19567 19567 19567 19567 19567 19567 1046 1041 1041 1041 1041 1041 1041 1041 1041 1067 1041 1041 1041 1041 1041 1041 1041 1041 1041 1041 1041 1041 1041 1041 1041 1041 1041 1041 1041 1041 1041 1041 1041 1041 1041 1041 1041 1041 1041 1041 1041 1041 1041 1041 1047 125 125 1046 1105 1105 1105 1105 1105 1105 1041 1041 1067 1041 1041
1041 1041 1041 1041 1041 1041 1041 1041 1041 1041 1041 1041 1041 1041 1041 1041 1041 1041 1047 19567 19567 19567 19567 19567 19567 19567 19567 19567 19567 1046 1041 1041 1041 1041 1041 1041 1041 1041 1041 1041 1041 1041 1041 1041 1041 1041 1041 1041 1041 1041 1041 1041 1041 1041 1041 1041 1041 1041 1041 1041 1041 1041 1041 1041 1041 1041 1041 1041 1041 1041 1041 1041 1041 1047 20492 20492 1046 1067 1041 1041 1041 1041 1041 1041 1041 1041 1041 1041
1041 1041 1041 1041 1041 1041 1041 1041 1041 1041 1041 1041 1041 1041 1041 1041 1041 1041 1106 1098 1098 1098 1098 1098 1098 1098 1098 1098 1098 1087 1041 1041 1041 1041 1041 1041 1041 1041 1041 1041 1041 1041 1041 1041 1041 1041 1041 1041 1041 1041 1041 1041 1041 1041 1041 1041 1041 1041 1041 1041 1041 1041 1041 1041 1041 1041 1041 1041 1041 1041 1041 1041 1041 1106 1131 1131 1087 1041 1041 1041 1067 1041 1041 1041 1041 1041 1041 1041
