77 51
1072 1073 1074 1073 1074 1073 1074 1073 1074 1073 1074 1073 1074 1073 1074 1072 1074 1073 1074 1073 1074 1073 1074 1073 1072 1075 1076 1077 1076 1077 1076 1076 1077 1076 1076 1077 1076 1077 1076 1077 1076 1076 1077 1076 1078 1079 1080 1081 1082 1083 1075 1084 1085 1077 1074 1073 1074 1073 1074 1073 1086 1073 1074 1073 1074 1073 1074 1073 1074 1073 1074 1073 1074 1073 1074 1073 1072
1072 1087 21530 21530 21530 21530 1088 21 24 23 24 116 116 116 23 1089 23 25 1087 21530 21530 21530 21530 1088 1075 1090 1074 1073 1074 1073 1074 1073 1074 1076 1077 1073 1074 1073 1074 1073 1074 1073 1074 1076 1091 1092 1093 1094 1095 1096 1090 1097 1098 1077 18 19 117 21 25 117 20 19 20 19 20 19 20 19 20 19 20 19 20 19 20 19 1089
1075 118 119 21 25 118 119 120 121 122 121 2 2 2 122 1099 122 40 123 124 39 40 123 124 1072 1072 21 25 20 19 20 1070 1071 1072 1072 1070 1071 20 19 20 19 20 19 1072 1100 1101 1102 1103 1078 1079 1080 1081 1072 1075 125 126 127 120 128 127 129 130 131 132 133 134 135 136 135 136 131 132 129 130 131 132 1099
1075 123 124 120 128 123 124 39 137 138 137 2 2 2 138 1086 138 40 139 140 39 40 139 140 1072 1075 120 128 141 142 141 142 141 1075 1072 143 142 141 142 141 142 144 126 1075 1104 1105 1106 1107 1091 1092 1093 1094 1075 1090 27 28 145 39 40 146 147 148 149 150 151 152 153 154 155 42 43 36 147 148 149 150 1108
1090 118 119 39 40 118 119 39 137 138 137 2 2 2 138 137 138 40 123 124 39 40 123 124 1075 1090 39 40 156 157 156 157 156 1090 1075 158 157 156 157 156 157 159 160 1076 1076 1077 1076 1077 1074 1073 1074 1073 1076 1077 27 28 145 39 40 161 162 157 162 157 163 157 156 157 29 164 165 28 162 157 162 157 1072
1072 166 167 39 40 166 167 39 137 138 137 1070 1071 2 138 137 138 40 139 140 39 40 139 140 1090 1072 39 40 1074 1073 1074 1109 1110 1072 1090 1109 1110 1074 1073 1074 1073 4112 4113 1072 1072 1072 1072 1072 18 19 20 19 1072 1075 27 28 145 39 40 1075 1111 1074 1073 1074 1073 1074 1073 1074 23593 23594 23595 23580 1073 1074 1073 1074 1089
1089 139 140 39 40 139 140 39 137 138 137 2 2 2 138 137 138 40 123 124 39 40 123 124 1072 1089 39 40 1075 1075 1074 1073 1074 1073 1074 1073 1074 1073 1074 1073 1074 3086 3087 1075 1075 1070 1110 19 168 132 144 126 1075 1090 169 34 146 39 40 1076 1080 1081 1112 1113 1080 1081 1080 1081 27 164 165 28 1080 1081 1112 1113 1099
1099 123 124 39 40 123 124 170 171 172 171 173 174 174 172 171 172 175 118 119 39 40 118 119 1089 1099 39 40 1090 1090 176 19 20 24 23 24 116 116 23 24 23 3086 3087 1090 1075 177 144 126 178 28 159 160 1090 1075 158 157 161 39 40 1076 1093 1094 1114 1115 1093 1094 1093 1094 169 34 35 34 1093 1094 1114 1115 1108
1108 118 119 39 40 118 119 1075 1074 1073 1074 1109 1110 1073 1074 1111 1074 1072 166 167 39 40 166 167 1099 1108 39 40 1075 1072 179 126 180 137 138 137 2 2 138 137 138 3086 3087 1075 1076 181 29 28 29 28 155 36 1074 1073 1074 1073 1072 39 40 1076 1082 1083 1080 1081 1082 1083 1080 1081 158 157 163 157 1082 1083 1080 1081 1072
1075 166 167 39 40 166 167 1090 1116 1116 1080 1081 1072 1100 1101 1102 1103 1072 118 119 39 40 118 119 1108 1075 39 40 1108 1072 179 28 2099 137 138 137 2 2 138 137 138 3086 3087 1090 1072 1109 1110 181 159 160 29 28 144 126 1072 1072 1072 39 40 1076 1095 1096 1093 1094 1095 1096 1093 1094 1072 1072 1072 1072 1095 1096 1093 1094 1089
1090 139 140 39 40 139 140 1089 1117 1117 1093 1094 1089 1104 1105 1106 1107 1089 166 167 39 40 166 167 1075 1090 39 40 1072 1072 179 28 2099 137 138 137 2 2 138 137 138 3086 3087 1099 1090 1090 1090 181 29 28 159 160 29 28 1075 1116 1075 39 40 1090 1086 1076 1077 1086 1076 1077 1086 1076 1077 1086 1073 1074 1073 1074 1076 1077 1099
1075 166 167 39 40 166 167 1118 1087 21530 21530 21530 21530 1088 1072 1080 1081 1099 139 140 39 40 139 140 1090 1072 39 40 1075 1099 179 28 2099 137 138 137 2 2 138 137 138 3086 3087 1108 1074 1073 1074 181 29 42 43 182 35 34 1090 1117 1090 39 40 20 19 20 19 20 19 20 19 20 19 20 19 20 19 20 19 117 1108
1090 139 140 39 40 139 140 44 18 19 20 183 19 20 1075 1093 1094 1108 123 124 39 40 123 124 1072 1072 39 40 1090 1108 179 28 2114 137 138 137 2 2 138 137 138 3086 3087 1072 1070 1071 184 185 29 164 165 28 1073 1074 1080 1081 1072 39 40 186 187 188 189 133 134 135 136 190 191 135 136 129 192 190 191 127 1072
1072 123 124 39 40 123 124 45 27 193 194 195 196 29 1090 1119 1120 1075 139 140 170 175 139 140 1075 1075 39 40 1072 1072 4112 4113 1089 137 138 137 2 2 138 137 138 1090 1075 1075 125 126 178 28 29 28 29 28 180 1090 1093 32838 32819 39 40 197 198 199 200 151 152 153 154 35 201 153 154 147 148 35 201 146 1075
1075 118 119 39 40 118 119 44 27 202 2 2 203 29 1089 1121 1122 1090 123 124 21 25 123 124 1090 1090 39 40 1072 1075 3086 3087 1089 137 138 137 2 2 138 137 138 1090 1072 1090 169 34 29 28 29 28 29 28 1075 1080 1081 32860 32834 170 175 156 157 156 157 163 157 156 157 156 157 156 157 156 157 156 157 204 1090
1090 166 167 39 40 166 167 45 27 205 206 207 208 29 1099 1123 1124 1072 118 119 120 128 118 119 1072 1072 39 40 1099 1090 3086 3087 1089 137 138 137 2 2 138 137 138 1090 1072 1072 1109 1110 27 28 29 42 43 28 1075 1093 1094 1117 1072 1073 1074 1075 1111 1076 1077 1111 1076 1077 1111 1076 1077 1111 1076 1077 32883 32883 1076 1077 1072
1072 139 140 39 40 139 140 44 169 34 3 4 154 35 1108 1125 1126 1089 166 167 39 40 166 167 1089 1089 39 40 1108 1072 3086 3087 1087 21530 21530 21530 21530 21530 21530 21530 21530 1088 1072 1125 1126 1075 27 28 29 164 165 28 1075 1076 1077 1080 1081 1112 1113 1090 1073 1074 1073 1074 1073 1074 1073 1074 1073 1072 1074 1073 32883 32883 1074 1073 1072
1089 123 124 170 175 123 124 45 158 157 5 6 157 163 1075 1121 1122 1090 118 119 39 40 118 119 1090 1090 39 40 1072 1072 13326 13327 1072 1074 1073 1074 1073 1074 1073 1074 1073 1074 1090 1127 1128 1125 1126 1075 41 28 29 28 1090 1084 1085 1093 1094 1114 1115 1099 12306 12307 12308 12307 12309 12310 12311 12312 12311 12312 12311 12312 12311 12313 12308 12307 1072
1099 1074 1073 1074 1073 1074 1073 1118 1073 1074 1073 1074 1073 1074 1090 1123 1124 1072 166 167 39 40 166 167 1072 1072 39 40 1075 1099 3086 3087 20 19 20 19 20 19 20 19 20 19 1099 1129 1130 1127 1128 1087 21531 21532 21533 21532 1088 1097 1098 1082 1083 1080 1081 1108 1070 1071 209 210 120 211 122 121 212 121 212 121 212 128 213 130 1089
1099 1087 21530 21530 21530 21530 21530 21530 1088 1086 1074 1073 1074 1073 1090 1125 1126 1089 139 140 39 40 139 140 1089 1089 39 40 1090 1108 3086 3087 214 215 129 192 216 217 190 191 144 126 1108 1131 1132 1080 1081 1075 27 28 29 28 1072 1112 1113 1095 1096 1093 1094 1072 169 201 218 219 39 220 138 137 138 137 138 137 138 40 221 222 1099
1072 123 124 19 20 19 20 123 124 19 20 19 20 19 1090 1127 1128 1099 123 124 39 40 123 124 1099 1099 170 175 1072 1072 3086 3087 223 224 147 148 225 226 35 201 29 28 1072 1112 1113 1093 1094 1075 27 28 29 28 1072 1114 1115 1119 1120 1076 1077 1075 158 157 156 157 170 227 172 171 172 171 172 171 172 175 156 157 1108
1072 139 140 126 144 126 144 139 140 126 144 126 1070 1071 1072 1129 1130 1072 139 140 170 175 139 140 1072 1108 21 25 1072 1075 3086 3087 162 157 156 157 162 157 162 157 29 28 1075 1114 1115 1080 1081 1090 27 42 43 28 1072 1082 1083 1121 1122 1084 1085 1090 1109 1110 1074 1073 1074 1073 1074 1073 1074 1073 1074 1073 1074 1073 1074 1073 1072
1075 123 124 34 35 34 35 123 124 34 35 34 35 34 1089 1131 1132 1089 123 124 21 25 123 124 1089 1075 120 128 1099 1090 1073 1074 1073 1074 1073 1074 1073 1074 1073 1075 4112 4113 1090 1082 1083 1093 1094 1099 27 164 165 28 1089 1095 1096 1123 1124 1097 1098 1072 1073 1074 1073 1074 1073 1074 1073 1074 1073 1074 1073 1074 1073 1074 1073 1074 1072
1090 139 140 157 163 157 163 139 140 157 163 157 163 157 1099 1084 1085 1099 118 119 120 128 118 119 1099 1090 39 40 1108 1072 1074 1073 1074 1073 1074 1073 1074 1073 1074 1090 13326 13327 1072 1095 1096 1119 1120 1108 27 28 21534 21530 1088 1072 228 19 20 19 21 25 24 116 116 116 116 116 116 116 116 116 116 116 116 23 21 25 1089
1072 123 124 1072 1073 1074 1073 1074 1073 1111 1073 1074 1109 1110 1108 1097 1098 1108 166 167 39 40 166 167 1108 1072 120 128 1072 1072 176 19 20 19 20 19 20 19 20 19 3086 3087 1099 1112 1113 1121 1122 1072 27 28 229 230 1075 1072 125 126 144 126 120 128 121 2 2 2 2 2 2 2 2 2 2 2 2 122 120 128 1099
1090 139 140 1087 21530 21530 21530 21530 1088 1072 1087 21530 21530 21530 21530 21530 1088 1075 139 140 39 40 139 140 1075 1075 39 40 1075 1099 231 126 232 233 144 126 214 215 129 192 3086 3087 1108 1114 1115 1123 1124 1075 27 28 234 235 1090 1072 27 28 29 28 39 40 137 2 2 2 2 2 2 2 2 2 2 2 2 138 39 40 1108
1072 123 124 21 24 23 24 23 24 23 24 23 24 23 25 123 124 1090 123 124 39 40 123 124 1090 1090 39 40 1090 1108 179 28 197 198 35 34 223 224 147 148 3086 3087 1072 1125 1126 1080 1081 1090 27 28 29 28 20 19 178 28 229 230 39 40 137 2 2 2 2 2 2 2 2 2 2 2 2 138 39 40 1072
1075 139 140 39 137 138 137 138 137 138 137 138 137 138 128 139 140 1072 139 140 39 40 139 140 1089 1072 39 40 1072 1072 179 160 162 157 163 157 162 157 156 157 3086 3087 1075 1127 1128 1093 1094 1087 21530 21535 29 28 144 126 29 28 234 235 39 40 137 2 2 2 2 2 2 2 21536 2 2 2 2 138 39 40 1075
1090 123 124 39 137 138 137 138 137 138 137 138 137 138 40 123 124 1089 123 124 39 40 123 124 1099 1089 39 40 1072 1072 4112 4113 1075 1073 1074 1073 1074 1073 1074 1073 1074 1073 1090 1072 1102 1103 1116 1099 27 28 29 28 236 237 238 239 29 28 39 40 137 2 2 2 2 2 2 2 21537 2 2 2 2 138 39 40 1090
1072 139 140 39 137 138 137 138 137 138 137 138 137 138 40 139 140 1099 118 119 39 40 118 119 1108 1099 39 40 1099 1099 13326 13327 1090 1086 1074 1086 1074 1086 1074 1073 1074 1073 1074 1073 1074 1099 1117 1108 27 28 240 241 242 243 29 28 159 160 39 40 137 2 22530 22530 2 2 2 2 21537 2 2 2 2 138 39 40 1072
1089 123 124 170 171 172 171 172 171 172 171 172 171 172 40 123 124 1108 166 167 39 40 166 167 1072 1072 39 40 1108 1108 3086 3087 20 19 20 19 20 19 20 19 20 19 20 19 117 1108 1075 1072 244 239 245 246 247 248 29 28 22557 22556 39 40 137 2 2 2 2 2 2 2 21537 2 2 2 2 138 39 40 1089
1099 1074 1073 1074 1073 1074 1073 1074 1073 1074 1073 1074 1073 1099 40 139 140 1075 139 140 39 40 139 140 1089 1089 39 40 1072 1072 3086 3087 216 217 144 126 214 215 129 192 144 126 144 1070 1071 1072 1090 1075 249 42 43 28 159 160 29 28 159 160 39 40 137 2 2 2 2 2 2 2 1111 2 2 2 2 138 39 40 1099
1099 1072 1072 1072 1086 1072 1072 1086 1072 1072 1086 1072 1072 1086 40 123 124 1090 123 124 39 40 123 124 1099 1099 39 40 1075 1075 3086 3087 225 226 35 34 223 224 147 148 35 34 35 34 146 1075 1116 1090 249 164 165 28 29 28 229 230 250 237 39 40 137 2 2 2 2 2 2 2 1075 2 2 2 2 138 1070 1071 1108
1072 123 124 21 24 23 24 23 24 23 24 23 24 23 40 118 119 1072 139 140 39 40 139 140 1108 1108 39 40 1090 1090 3086 3087 162 157 163 157 162 157 156 157 163 157 163 157 251 1090 1117 1075 252 34 35 22562 22563 34 35 34 147 148 39 40 137 2 2 2 2 2 2 2 1090 2 2 2 2 138 39 40 1089
1072 139 140 120 137 138 137 138 137 138 137 138 137 138 40 166 167 1089 123 124 39 40 123 124 1072 1075 170 175 1072 1073 1074 1073 1074 1111 1074 1111 1074 1111 1074 1073 1074 1073 1074 1109 1110 1072 1075 1087 21530 21530 21530 21530 21530 21530 21530 21530 21530 21530 21530 21530 21530 21530 21530 21530 21530 21530 21530 21530 1088 1080 1081 174 174 172 170 175 1099
1075 123 124 39 137 138 137 138 137 138 137 138 137 138 40 139 140 1099 118 119 39 40 118 119 1075 1090 21 25 1072 1074 1073 1074 1073 1074 1073 1074 1073 1074 1073 1074 1073 1074 1073 1074 1073 1099 1090 1072 1073 1074 1073 1074 1073 1074 1073 1074 1073 1074 1073 1074 1073 1074 1073 1074 1073 1074 1073 1074 1072 1093 1094 1074 1073 1074 1109 1110 1108
1090 139 140 170 171 172 171 172 171 172 171 172 171 172 175 166 167 1108 166 167 170 175 166 167 1090 1075 120 128 20 19 20 19 20 19 20 19 20 19 20 19 117 21 25 1108 1116 1108 1116 1072 1074 1073 1074 1073 1074 1073 1074 1073 1074 1073 1074 1073 1074 1073 1074 1073 1074 1073 1074 1073 1074 1073 1074 1073 1086 1073 1074 1073 1072
1072 123 124 1072 1111 1074 1073 1111 1073 1074 1111 1074 1073 1111 1073 1074 1073 1089 139 140 21 25 139 140 1089 1090 39 40 144 126 144 126 144 126 144 126 144 126 144 126 127 120 128 1072 1117 1072 1080 1081 1082 1083 1075 1084 1085 1072 18 19 20 19 21 24 116 23 25 117 20 19 20 19 20 19 20 19 20 19 20 19 1075
1089 118 119 1072 1072 1072 1072 1072 1072 1072 1072 1072 1072 1072 1072 1072 1072 1072 123 124 120 128 123 124 1099 1072 39 40 155 36 159 160 253 37 38 254 29 28 255 256 145 39 40 46 47 1075 1093 1094 1095 1096 1090 1097 1098 1075 1070 1071 190 191 120 121 2 122 128 127 190 191 190 191 133 134 214 215 135 136 1070 1071 1090
1099 166 167 1089 1116 1080 1081 1072 1116 1116 1080 1081 1072 1116 1116 1102 1103 1089 139 140 39 40 139 140 1108 1089 39 40 257 258 259 260 261 2 2 262 29 28 242 243 145 39 40 144 126 1090 1108 1080 1081 1133 1134 1080 1081 1090 252 34 35 201 39 137 2 138 40 146 35 201 35 201 151 152 223 224 153 154 35 34 1072
1108 118 119 1099 1117 1093 1094 1089 1117 1117 1093 1094 1089 1117 1117 1106 1107 1099 123 124 39 40 123 124 1108 1099 39 40 263 264 2 265 266 2 2 262 155 36 247 248 145 39 40 35 34 1072 1089 1093 1094 1135 1136 1093 1094 1072 158 157 156 157 39 137 2 138 40 204 156 157 156 157 163 157 156 157 156 157 156 157 1072
1072 166 167 1087 21530 21530 21530 21530 1088 1072 1087 21530 21530 21530 21530 21530 21530 1088 118 119 39 40 118 119 1072 1072 39 40 267 207 206 268 266 2 2 269 29 28 159 160 145 39 40 1109 1110 1072 1117 1082 1083 1108 1080 1081 1076 1077 1109 1110 1074 1087 21530 21530 21530 21530 21530 1088 1074 1073 1074 1073 1074 1073 1074 1073 1111 1073 1109 1110 1072
1075 139 140 21 24 23 24 23 24 23 24 23 24 23 25 118 119 1072 166 167 39 40 166 167 1089 1089 39 40 29 28 29 28 270 271 272 273 29 28 29 28 145 39 40 1072 1075 1099 1072 1095 1096 1089 1093 1094 1077 1119 1120 1102 1103 1075 39 137 2 138 40 1072 1076 1077 1075 1076 1077 1075 1080 1081 1080 1081 1075 1076 1077
1090 123 124 120 121 212 121 212 121 212 121 212 121 212 128 166 167 1089 139 140 39 40 139 140 1099 1099 39 40 29 28 155 22564 22557 28 29 28 253 22565 22566 254 145 39 40 1108 1100 1101 1102 1103 1080 1081 1133 1134 1108 1121 1122 1125 1126 1090 39 137 2 138 40 1075 1080 1081 1112 1113 1084 1085 1093 1094 1093 1094 1100 1101 1102
1072 118 119 39 137 138 137 138 137 138 137 138 137 138 40 139 140 274 123 124 39 40 123 124 1108 1108 39 40 240 241 255 256 155 36 245 246 261 2 2 262 145 39 40 1099 1104 1105 1106 1107 1093 1094 1135 1136 1089 1123 1124 1127 1128 1075 32883 32883 32883 32883 32883 1090 1093 1094 1114 1115 1097 1098 1076 1077 1075 1076 1104 1105 1106
1089 166 167 39 137 138 137 138 137 138 137 138 137 138 40 123 124 275 139 140 39 40 139 140 1072 1075 39 40 245 246 242 243 29 28 29 28 266 2 2 262 145 39 40 1108 1075 1075 1116 1075 1074 1073 1074 1073 1074 1073 1074 1073 1074 1090 39 137 2 138 40 1086 1073 1074 1073 1074 1073 1074 1073 1074 1075 1074 1073 1074 1072
1099 1090 1072 39 137 138 137 138 137 138 137 138 137 138 40 118 119 275 123 124 39 40 166 167 1075 1090 39 40 29 28 247 248 29 28 276 277 266 2 2 269 145 39 40 1072 1090 1090 1117 1090 18 19 20 19 20 19 20 19 20 19 39 137 2 138 40 117 20 19 20 19 20 19 20 19 1090 19 20 19 1075
1080 1081 1075 170 171 172 171 172 171 172 171 172 171 172 175 166 167 278 139 140 170 175 139 140 1090 1072 22567 22568 159 160 155 36 29 28 279 280 270 271 272 273 145 39 40 1075 1116 1072 1075 1075 1070 1071 133 134 216 217 190 191 188 189 39 137 2 138 40 127 186 187 190 191 188 189 133 134 216 217 281 282 1090
1137 1138 1087 21530 21530 21530 21530 21530 21530 21530 21530 21530 21530 21530 21530 21530 21530 1088 1073 1074 1073 1074 1073 1074 1089 1089 39 40 35 34 35 34 35 34 35 34 35 34 35 34 146 39 40 1090 1117 1072 1090 1090 252 34 151 152 197 198 35 201 199 200 39 137 2 138 40 146 197 198 35 201 199 200 151 152 197 198 35 201 1072
1093 1094 1072 1073 1074 1073 1074 1073 1074 1073 1074 1073 1074 1073 1074 1073 1074 1072 1102 1103 1116 1116 1080 1081 1099 1087 21530 21530 21530 21530 21530 21530 21530 21530 21530 21530 21530 21530 21530 21530 21530 21530 21530 1088 1080 1081 1075 1075 158 157 163 157 156 157 156 157 156 157 170 171 174 172 175 204 156 157 156 157 156 157 163 157 156 157 156 157 1072
1082 1083 1080 1081 1080 1081 1080 1081 1112 1113 1116 1116 1080 1081 1080 1081 1080 1081 1106 1107 1117 1117 1093 1094 1099 1072 1073 1074 1073 1074 1073 1074 1073 1074 1073 1074 1073 1074 1073 1074 1073 1074 1073 1072 1093 1094 1090 1090 1109 1110 1074 1073 1074 1073 1074 1073 1074 1073 1074 1073 1074 1073 1074 1111 1074 1073 1074 1073 1074 1073 1074 1073 1074 1073 1074 1073 1072
