56 95
1086 1087 1088 1089 1081 1082 1090 1091 1092 1093 1081 1082 1086 1087 1088 1089 1081 1082 1090 1091 1092 1093 1081 1082 1086 1087 1088 1089 1081 1082 1086 1087 1088 1089 1081 1082 1090 1091 1092 1093 1081 1082 1094 1095 1094 1095 1094 1095 1094 1095 1094 1095 1094 1095 1094 1085
1085 1095 1094 1096 1094 1095 1094 1095 1094 1095 1094 1095 1094 1095 1094 1095 1075 1085 1094 1095 1094 1095 1094 1095 1094 1095 1094 1085 1085 1095 1094 1095 1094 1095 1094 1095 1085 1094 1095 1094 1070 1085 116 117 32 117 118 119 120 121 122 123 124 118 119 1075
1085 116 117 32 117 32 117 3086 3087 32 117 32 117 32 117 125 1080 1070 1070 118 119 120 124 118 119 32 117 1075 1075 116 117 32 117 32 117 32 117 32 1097 1098 1099 1085 126 127 128 129 130 131 132 133 2 134 135 130 131 1085
1085 136 137 138 139 138 139 3088 3089 140 141 142 127 142 127 143 1075 1099 1099 130 131 132 135 130 131 138 139 1080 1080 144 145 146 145 146 145 146 145 146 145 146 1085 1075 147 148 149 150 118 119 18 19 2 20 21 118 119 1075
1075 147 42 151 42 151 42 3088 3089 152 153 25 148 151 148 154 1080 1085 1085 118 119 18 21 118 119 39 40 1100 1100 155 156 157 156 157 156 157 156 157 156 157 1075 1080 158 156 157 156 159 160 18 19 2 20 21 159 160 1080
1080 158 156 161 156 161 156 3088 3089 161 156 162 156 162 156 163 1085 1075 1075 159 160 18 21 159 160 39 40 1099 1075 4110 4111 1070 1094 1095 1094 1095 1094 1085 1101 1102 1100 1080 32883 32883 1103 1085 37 36 18 19 2 20 21 37 36 1100
1100 1094 1100 1104 21537 21538 21539 3088 3089 1105 21538 21538 21538 1106 1085 1094 1075 1080 1080 37 36 18 21 37 36 39 40 1085 1080 3088 3089 1099 1095 1094 1095 1094 1095 1094 1095 1094 1095 1085 32883 32883 1099 1105 21538 21538 21539 19 2 20 21 159 160 1085
1071 1072 1076 1107 1077 1108 1109 3088 3089 1076 1107 1077 1076 1077 1108 1109 1085 1085 1085 130 131 18 21 130 131 39 40 1085 1080 3088 3089 125 32 117 32 117 32 117 32 117 32 117 32 117 1099 1085 118 119 18 19 2 20 21 37 36 1085
1083 1084 1081 1110 1082 1111 1112 3088 3089 1081 1110 1082 1081 1082 1111 1112 1085 1075 1075 118 119 18 21 118 119 39 40 32 117 3088 3089 143 164 165 142 127 138 139 166 167 168 169 128 129 32829 32829 130 131 18 19 2 20 21 130 131 1075
1085 1095 1094 1095 1094 1095 1094 3088 3089 1094 1095 1094 1095 1094 1095 1094 1085 1075 1075 130 131 18 21 130 131 39 40 142 127 3088 3089 41 170 171 39 40 28 29 172 173 174 175 149 150 32819 32819 118 119 18 19 2 20 21 118 119 1080
1085 116 117 32 117 32 117 3088 3089 32 117 32 117 32 117 32 1075 1100 1100 118 119 43 44 118 119 39 29 28 29 3088 3089 176 157 156 28 29 39 40 157 156 157 156 157 156 32824 32824 159 160 18 19 2 21537 21538 21538 21538 1106
1085 177 139 178 179 178 179 3088 3089 164 165 178 179 142 127 142 1080 1099 1095 1094 1095 1094 1095 1094 1095 23597 23592 23580 23581 1094 1095 1094 1095 1075 23597 23592 23580 23581 1075 1094 1095 1094 1095 1094 1100 1075 37 36 18 19 2 20 21 118 119 1085
1075 147 42 180 181 180 181 3088 3089 170 171 180 181 182 148 25 1100 1113 1109 1076 1077 1076 1077 1114 1115 183 40 184 185 1076 1077 1114 1115 1080 183 40 184 185 1080 1076 1077 1076 1077 1076 1077 1080 130 131 18 19 2 20 21 159 160 1080
1080 158 156 161 156 161 156 3088 3089 161 156 162 156 162 156 162 1085 1116 1112 1081 1082 1081 1082 1090 1091 186 42 25 42 1081 1082 1090 1091 1100 186 42 25 42 1100 1081 1082 1081 1082 1081 1082 1100 118 119 18 19 2 20 21 37 36 1100
1100 4167 4166 1095 1094 1095 1094 1095 1094 1095 1094 1095 1094 1095 4166 4167 1085 1070 1117 1118 1119 1085 1118 1119 1118 155 156 157 156 1118 1119 1118 1119 1085 155 156 157 156 1085 1117 1118 1119 1117 1118 1119 1085 130 131 18 19 2 20 21 130 131 1085
1085 3124 3155 1077 1076 1077 1108 1109 1070 1071 1072 1080 1076 1077 3156 3157 1120 1070 1094 1095 1094 1095 1094 1095 1094 1095 1094 1095 1094 1095 1094 1095 1094 1095 1094 1095 1094 1095 1094 1095 1094 1095 1094 1095 1099 1085 118 119 18 19 2 20 21 118 119 1085
1075 3129 3158 1082 1081 1082 1111 1112 1099 1083 1084 1100 1081 1082 3159 3160 1085 1099 120 3088 3089 122 122 122 122 3088 3089 122 122 122 3088 3089 122 122 122 3088 3089 122 123 124 32 117 32 117 1075 1105 21538 21538 21538 21538 21539 20 21 130 131 1075
1080 3143 3142 1095 1094 1095 1094 1095 1094 1095 1094 1095 1094 1095 3133 3133 1118 1070 132 3088 3089 2 2 2 2 3088 3089 2 2 2 3088 3089 2 2 2 3088 3089 2 187 135 166 167 178 179 1080 1080 118 119 18 19 2 20 21 118 119 1080
1085 3086 3087 120 121 122 122 122 122 122 123 124 1080 1100 116 117 1077 1099 18 3088 3089 2 2 2 2 3088 3089 2 2 2 3088 3089 2 2 2 3088 3089 2 20 21 172 173 180 181 32814 32829 159 160 18 19 2 20 21 159 160 1085
1085 3088 3089 132 133 2 2 2 2 2 134 135 1100 1099 177 139 1082 1085 18 3088 3089 2 2 2 2 3088 3089 2 2 2 3088 3089 2 2 2 3088 3089 2 20 21 157 156 157 156 32843 32814 37 36 18 19 2 20 21 37 36 1085
1075 3088 3089 18 19 2 2 2 2 2 20 21 32829 32862 147 42 1072 1085 132 3088 3089 2 2 2 2 3088 3089 2 2 2 3088 3089 2 2 2 3088 3089 2 20 21 1075 1094 1095 1094 1075 1099 130 131 18 19 2 20 21 130 131 1075
1080 3088 3089 43 188 189 189 189 189 189 190 44 32829 32862 158 156 1084 1085 18 3088 3089 2 2 2 2 2 2 2 2 2 2 2 2 2 2 2 2 2 20 21 1100 1076 1077 1076 1077 1075 118 119 18 19 2 20 21537 21538 21538 1106
1085 1094 1095 1094 1095 1094 1095 1094 1095 1094 1095 1094 1095 1094 1085 1085 1118 1070 18 3088 3089 2 2 2 2 2 2 2 2 2 2 2 2 2 2 2 2 2 20 21 1085 1081 1082 1081 1082 1080 130 131 18 19 2 20 21 130 131 1100
1099 1095 1094 1095 1094 1095 1094 1095 1094 1095 1070 1095 1094 1095 1094 1095 1094 1099 18 3088 3089 1105 21538 21538 21538 21538 21538 21538 21538 21538 21538 21538 21538 21538 21538 21538 21538 21538 21538 21538 1106 1095 1094 1095 1096 1105 21538 21538 21539 19 2 20 21 118 119 1085
1070 191 32 117 32 117 32 117 32 117 1099 32 117 32 117 32 117 125 18 19 2 2 2 2 2 2 2 2 2 2 2 2 2 2 2 2 2 2 20 21 32 117 32 117 120 124 159 160 18 19 2 20 21 159 160 1085
1099 192 178 179 193 194 164 165 142 127 125 164 165 142 127 142 127 195 18 19 2 2 2 2 2 2 2 2 2 2 2 2 2 2 2 2 2 2 20 21 178 179 166 167 132 135 37 36 18 19 2 20 21 37 36 1075
1099 196 180 181 197 198 170 171 25 148 41 170 171 25 148 151 148 41 18 19 2 2 2 2 2 2 2 2 2 2 2 2 2 2 2 2 2 2 20 21 180 181 172 173 18 21 130 131 18 19 2 20 21 130 131 1080
1070 199 162 156 162 156 162 156 162 156 200 162 156 162 156 162 156 200 43 188 189 189 189 189 189 189 189 189 189 189 189 189 189 189 189 189 189 189 190 44 157 156 157 156 43 44 118 119 43 188 189 190 44 118 119 1075
1099 1095 1094 1095 1094 1095 1094 1095 1094 1095 1094 1095 1094 1095 1094 1095 1094 1095 1094 1095 1094 1095 1094 1095 1094 1095 1094 1095 1094 1095 1094 1095 1094 1095 1094 1095 1094 1095 1094 1095 1094 1095 1094 1085 1104 1085 1095 1094 1095 1094 1095 1094 1095 1094 1095 1080
1074 1117 1118 1119 1085 1118 1119 1118 1119 1076 1077 1070 1076 1107 1077 1075 1073 1074 1117 1118 1119 1085 1118 1119 1118 1119 1076 1077 1070 1076 1107 1077 1075 1073 1074 1117 1118 1119 1085 1118 1119 1118 1119 1076 1077 1070 1076 1107 1077 1075 1073 1074 1117 1118 1119 1085
1079 1113 1109 1076 1077 1076 1077 1114 1115 1081 1082 1099 1081 1110 1082 1080 1078 1079 1113 1109 1076 1077 1076 1077 1114 1115 1081 1082 1099 1081 1110 1082 1080 1078 1079 1113 1109 1076 1077 1076 1077 1114 1115 1081 1082 1099 1081 1110 1082 1080 1078 1079 1113 1109 1076 1077
1121 1116 1112 1081 1082 1081 1082 1090 1091 1076 1107 1077 1117 1118 1119 1100 1122 1121 1116 1112 1081 1082 1081 1082 1090 1091 1076 1107 1077 1117 1118 1119 1100 1122 1121 1116 1112 1081 1082 1081 1082 1090 1091 1076 1107 1077 1117 1118 1119 1100 1122 1121 1116 1112 1081 1082
1077 1114 1115 1076 1077 1123 1124 1076 1077 1081 1110 1082 46 47 48 46 1076 1077 1114 1115 1076 1077 1123 1124 1076 1077 1081 1110 1082 46 47 48 46 1076 1077 1114 1115 1076 1077 1123 1124 1076 1077 1081 1110 1082 46 47 48 46 1076 1077 1114 1115 1076 1077
1082 1090 1091 1081 1082 1092 1093 1081 1082 1117 1118 1119 1099 1083 1084 1099 1081 1082 1090 1091 1081 1082 1092 1093 1081 1082 1117 1118 1119 1099 1083 1084 1099 1081 1082 1090 1091 1081 1082 1092 1093 1081 1082 1117 1118 1119 1099 1083 1084 1099 1081 1082 1090 1091 1081 1082
1085 1094 1095 1085 1105 21538 21538 21538 1106 1070 1105 21538 21538 21538 1106 1095 1085 1070 1085 1094 1095 1094 1095 1094 1095 1094 1095 1094 1095 1094 1095 1094 1095 1094 1095 1094 1095 1094 1095 1085 1070 1085 1095 1094 1095 1094 1095 1094 1095 1094 1095 1094 1095 1094 1095 1085
1075 201 202 202 117 159 160 120 121 122 123 124 159 160 32 202 117 1099 120 121 122 122 122 122 122 122 122 122 122 122 122 122 122 122 122 123 124 32 202 202 202 117 1099 3086 3087 120 121 122 123 121 122 123 124 120 124 1085
1080 203 204 204 40 37 36 132 133 2 134 135 37 36 39 204 40 125 132 133 2 2 2 2 2 2 2 2 2 2 2 2 2 2 2 134 135 39 204 204 204 40 125 3088 3089 132 133 2 134 133 2 134 135 132 135 1075
1100 203 204 204 40 130 131 18 19 2 20 21 130 131 25 26 42 41 18 19 2 2 2 2 2 2 2 2 2 2 2 2 2 2 2 20 21 25 26 26 26 42 41 3088 3089 18 19 2 20 19 2 20 21 18 21 1080
1075 203 204 204 40 118 119 18 19 2 20 21 118 119 161 205 156 163 18 19 2 2 2 2 2 2 2 2 2 2 2 2 2 2 2 20 21 161 205 205 205 156 163 3088 3089 18 19 2 20 19 2 20 21 18 21 1100
1080 206 26 26 42 159 160 18 19 2 20 21 159 160 1085 1095 1094 1085 12306 12307 12290 12290 12290 12290 4112 4113 12290 12290 12290 12290 12290 12290 12290 12290 12290 4112 4113 1070 1094 1095 1094 1095 1085 13328 13329 12306 12307 12290 12308 12307 12290 12308 12309 12306 12309 1085
1100 207 205 205 156 37 36 18 19 2 20 21 21537 21538 1106 1077 32829 32829 18 19 2 2 2 2 3088 3089 2 2 2 2 2 2 2 2 2 3088 3089 1099 1076 1077 1070 1077 1070 3088 3089 18 19 2 20 19 2 20 21 18 21 1085
1085 1095 1094 1095 1085 159 160 18 19 2 20 21 159 160 1080 1074 32819 32819 43 188 189 189 189 189 3088 3089 189 189 189 189 189 189 189 189 189 3088 3089 1070 1073 1074 1099 1074 1099 3088 3089 18 19 2 20 19 2 20 21 18 21 1075
1076 1077 1114 1115 1085 37 36 18 19 2 20 21 37 36 1100 1079 1080 1080 1085 1095 1094 1095 1094 1095 1094 1095 1094 1095 1094 1095 1094 1095 1094 1095 1094 1095 1094 1099 1078 1079 1070 1079 1070 3088 3089 43 188 189 190 188 189 190 44 18 21 1080
1081 1082 1090 1091 1075 130 131 18 19 2 20 21 130 131 1085 1076 1077 1085 1085 1070 1085 1085 1085 1085 1075 1070 1085 1085 1085 1075 1085 1075 1085 1085 1075 1085 1085 1075 1122 1121 1099 1121 1105 21538 21538 21538 21538 22562 22562 21538 21538 21538 1106 18 21 1085
1123 1124 1076 1077 1105 21538 21538 21539 19 2 20 21 118 119 1085 49 50 51 52 53 1076 1107 1077 1076 1107 1077 1076 1077 1076 1107 1077 1076 1107 1077 1076 1077 1075 1095 1094 1095 1094 1095 1094 1095 1094 1095 1094 1095 1094 1095 1094 1085 1085 18 21 1085
1092 1093 1081 1082 1100 159 160 18 19 2 20 21 159 160 1070 54 55 56 57 58 1081 1110 1082 1081 1110 1082 1081 1082 1081 1110 1082 1081 1110 1082 1081 1082 116 117 32 117 32 117 32 117 32 117 32 117 32 117 125 1085 1085 18 21 1085
1108 1109 1071 1072 1085 37 36 18 19 2 20 21 37 36 1099 4194 4193 1085 12358 12359 1094 1095 1094 1095 1094 1095 1094 1095 1094 1095 1094 1095 1094 1095 1094 1075 177 139 164 165 138 139 178 179 138 139 164 165 138 139 143 1085 1075 18 21 1075
1111 1112 59 60 61 159 160 18 19 2 20 21 159 160 1070 13373 13373 1096 202 202 202 202 117 120 121 122 122 122 122 122 123 124 208 139 120 124 12310 40 28 29 209 210 211 212 39 40 213 214 215 38 216 1075 1080 18 21 1080
1076 1077 52 53 51 37 36 18 19 2 20 21 37 36 1099 120 124 138 204 204 204 204 40 18 19 2 2 2 2 2 20 21 204 40 18 21 12311 217 39 40 218 219 220 221 222 223 224 225 2 226 31 1080 1100 18 21 1100
1073 1074 1081 1082 1099 130 131 18 19 2 20 21 130 131 1085 132 135 39 204 204 204 204 40 18 19 2 2 2 2 2 20 21 204 40 18 21 12312 227 28 29 28 29 228 229 230 231 232 233 234 235 31 1103 1120 18 21 1085
1078 1079 1113 1109 1085 118 119 18 21537 21538 21539 21 118 119 1070 12306 12309 12313 12314 12314 12314 4112 4113 12306 12307 12290 12290 12290 12290 12290 12308 12309 4112 4113 12306 12309 12315 30 28 29 228 236 28 29 39 40 39 40 28 29 31 32 117 18 21 1085
1122 1121 1116 1112 1075 159 160 18 19 2 20 21 159 160 1099 43 44 161 205 205 205 3088 3089 43 188 189 189 189 189 189 190 44 3088 3089 43 44 23 217 23 217 28 29 213 214 215 38 237 238 39 40 31 138 139 18 21 1075
1114 1115 1076 1077 1080 37 36 18 19 2 20 21 37 36 1070 4110 4111 1104 1085 1094 1095 1094 1095 1094 1095 1094 1095 1094 1095 1094 1095 1094 1095 1094 1095 1075 239 40 24 227 39 40 224 225 2 226 24 227 39 40 31 240 241 18 21 1080
1090 1091 1081 1082 1100 159 160 18 19 2 20 21 159 160 1099 13328 13329 1085 1094 1095 1094 1095 1094 1095 1094 1095 1094 1095 1094 1095 1085 1075 1094 1095 1085 1080 183 40 27 30 39 40 232 233 234 235 27 30 28 29 31 242 243 18 21 1085
1076 1077 1114 1115 1085 37 36 18 19 2 20 21 37 36 1085 3088 3089 120 121 122 122 123 124 32 117 32 117 32 117 125 1075 1080 244 117 1085 1100 183 40 28 29 28 29 39 40 184 245 39 40 39 40 31 161 156 18 21 1085
1081 1082 1090 1091 1085 130 131 18 19 2 20 21 130 131 1085 3088 3089 132 133 2 2 134 135 138 139 138 139 138 139 143 1080 1100 177 139 1075 1085 183 40 213 214 215 22566 22567 40 28 29 246 247 28 29 31 21537 21539 18 21 1070
1075 1094 1095 1094 1075 118 119 18 19 2 20 21537 21538 21538 1106 3088 3089 18 19 2 2 20 21 39 40 209 210 23 217 31 1100 1085 248 223 1080 1085 183 40 224 225 2 226 246 247 220 221 249 250 39 22568 22569 1077 1075 18 21 1099
201 117 32 117 125 159 160 18 19 2 20 21 159 160 1075 3088 3089 18 19 2 2 20 21 28 29 218 219 24 227 31 1117 1119 183 40 1100 1075 183 40 232 233 234 235 249 250 228 251 39 40 28 29 1125 1126 1080 18 21 1070
252 139 142 127 143 37 36 18 19 2 20 21 37 36 1080 13328 13329 12306 12307 12290 12290 12308 12309 4112 4113 12316 12317 12315 12318 12319 12320 117 136 137 1075 1080 183 40 39 40 184 245 39 40 184 185 246 247 184 185 1081 1082 1075 18 21 1099
206 42 151 148 41 159 160 18 19 2 20 21 159 160 1100 3088 3089 18 19 2 2 20 21 3088 3089 25 42 25 42 41 25 42 25 42 1080 1085 147 22570 22553 42 25 42 25 42 25 42 25 42 25 42 1127 1128 1080 18 21 1085
207 156 162 156 176 37 36 43 188 189 190 44 37 36 1085 3088 3089 43 188 189 189 190 44 3088 3089 161 156 161 156 176 161 156 161 156 1085 1105 21538 21538 21538 21538 21538 21538 21538 21538 21538 21538 21538 21538 21538 21538 1106 1129 1100 22571 22572 1070
1075 1094 1095 1094 1095 1094 1095 1094 1095 1094 1095 1094 1095 1085 1075 1094 1095 1094 1095 1094 1095 1094 1095 1094 1095 1094 1095 1094 1095 1094 1085 1085 1075 1094 1095 1094 1095 1094 1095 1094 1095 1094 1095 1094 1095 1094 1095 1085 1092 1093 1117 1119 1085 1095 1094 1099
1076 1107 1077 1076 1107 1077 1076 1077 1076 1077 1076 1077 1076 1107 1077 1076 1107 1077 1076 1077 1076 1077 1076 1077 1076 1107 1077 1076 1107 1077 1076 1077 1076 1077 1076 1077 1076 1107 1077 1076 1107 1077 1076 1077 1076 1077 1076 1077 1076 1107 1077 1076 1107 1077 1076 1077
1081 1110 1082 1081 1110 1082 1081 1082 1073 1074 1081 1082 1081 1110 1082 1081 1110 1082 1081 1082 1073 1074 1081 1082 1081 1110 1082 1081 1110 1082 1081 1082 1073 1074 1081 1082 1081 1110 1082 1081 1110 1082 1081 1082 1073 1074 1081 1082 1081 1110 1082 1081 1110 1082 1081 1082
1114 1115 1073 1074 1130 1131 1123 1124 1078 1079 1113 1109 1114 1115 1117 1118 1119 1117 1117 1118 1119 1117 1118 1119 1114 1115 1073 1074 1130 1131 1123 1124 1078 1079 1113 1109 1114 1115 1073 1074 1130 1131 1123 1124 1078 1079 1113 1109 1114 1115 1073 1074 1130 1131 1123 1124
1090 1091 1078 1079 1132 1133 1092 1093 1122 1121 1116 1112 1090 1099 1094 1095 1094 1095 1094 1095 1094 1095 1094 1095 1099 1091 1078 1079 1132 1133 1092 1093 1122 1121 1116 1112 1090 1085 1094 1095 1094 1095 1094 1095 1094 1095 1094 1095 1085 1091 1078 1079 1132 1133 1092 1093
1085 1095 1094 1095 1085 1096 1085 1094 1095 1094 1095 1094 1085 1105 21538 21538 21538 21538 21538 21538 21538 21538 21538 21538 1106 1099 1094 1070 1094 1095 1094 1095 1094 1095 1094 1095 1099 1099 1105 21538 21538 21538 21538 21538 21538 21538 21538 1106 1094 1095 1094 1070 1094 1095 1094 1070
1085 191 32 117 32 117 32 117 32 117 32 117 120 124 37 36 120 121 122 122 123 124 37 36 120 124 32 1099 116 117 32 117 32 117 32 117 1070 1099 37 36 120 121 122 122 123 124 37 36 32 117 32 1099 116 117 125 1099
1075 192 168 169 142 127 166 167 193 194 178 179 132 135 159 160 132 133 2 2 134 135 159 160 132 135 142 127 253 141 164 165 178 179 166 167 1099 1070 159 160 132 133 2 2 134 135 159 160 138 139 178 179 253 136 137 1085
1080 196 174 175 25 148 172 173 197 198 180 181 18 21 37 36 18 19 2 2 20 21 37 36 18 21 25 148 254 255 170 171 180 181 172 173 1085 1099 37 36 18 19 2 2 20 21 37 36 39 40 180 181 254 255 41 1085
1100 199 157 156 157 156 157 156 161 156 157 156 18 21 130 131 18 19 2 2 20 21 130 131 18 21 157 156 157 156 157 156 157 156 157 156 1085 1085 130 131 18 19 2 2 20 21 130 131 211 212 161 156 157 156 200 1085
1085 1095 1094 1095 1085 1104 1085 1095 1094 1095 1094 1075 18 21 118 119 18 19 2 2 20 21 118 119 18 21 1070 1094 1095 1094 1095 1094 1095 1094 1095 1094 1085 1085 118 119 18 19 2 2 20 21 118 119 220 221 1070 1095 1094 1095 1094 1070
1085 1094 1095 1094 1095 1094 1095 1094 1095 1094 1095 1080 18 21 159 160 18 19 2 2 20 21 159 160 18 21 1099 1094 1095 1094 1099 1070 1094 1095 1094 1095 1094 1085 159 160 18 19 2 2 20 21 159 160 228 229 1099 1095 1094 1095 1094 1099
1075 116 117 32 117 32 117 32 117 32 117 125 18 21 37 36 18 19 2 2 20 21 37 36 18 21 32 117 32 117 1070 1099 244 117 32 117 32 117 37 36 18 19 2 2 20 21 37 36 184 245 120 121 122 123 124 1070
1080 177 139 138 139 256 257 258 139 138 139 143 18 21 159 160 18 19 2 2 20 21 159 160 18 21 256 257 259 260 1099 1070 177 139 138 139 138 139 159 160 18 19 2 2 20 21 159 160 39 40 132 133 2 134 135 1099
1085 183 261 262 263 264 265 266 267 184 185 216 18 21 37 36 18 19 2 2 20 21 37 36 18 21 224 225 2 226 1070 1099 183 40 24 227 39 40 37 36 18 19 2 2 20 21 37 36 222 223 18 19 2 20 21 1085
1085 183 268 269 229 270 2 271 263 240 241 31 18 21 130 131 18 19 2 2 20 21 130 131 18 21 232 233 234 235 1099 1085 183 40 27 30 39 40 130 131 18 19 2 2 20 21 130 131 230 231 18 19 2 20 21 1085
1085 147 42 25 272 273 274 275 181 242 243 41 18 21 118 119 18 19 2 2 20 21 118 119 18 21 25 42 170 171 1085 1085 147 42 25 42 25 42 118 119 18 19 2 2 20 21 118 119 25 42 18 19 2 20 21 1085
1085 158 156 161 156 161 156 161 156 161 156 200 18 21 159 160 18 19 2 2 20 21 159 160 18 21 161 156 162 156 1085 1085 158 156 161 156 161 156 159 160 18 19 2 2 20 21 159 160 161 156 43 188 189 190 44 1070
1085 1095 1094 1095 1094 1095 1094 1095 1094 1095 1094 1075 18 21 37 36 18 19 2 2 20 21 37 36 18 21 1070 1095 1094 1095 1094 1070 4110 4111 1070 1094 1095 1085 1105 21540 21522 21523 21506 21506 21524 21525 21541 1106 1085 1094 1095 1094 1095 1094 1095 1099
1075 1094 1095 1094 1095 1094 1095 1094 1095 1094 1095 1080 18 21 159 160 18 19 2 2 20 21 159 160 18 21 1099 1094 1095 1094 1095 1099 3088 3089 1099 1095 1094 1095 1085 160 18 19 2 2 20 21 159 1085 1094 1095 1094 1095 1094 1095 1094 1070
1080 120 121 122 122 122 122 122 122 122 123 124 18 21 37 36 18 19 2 2 20 21 37 36 18 21 32 117 32 117 32 117 32 117 32 117 32 117 37 36 18 19 2 2 20 21 37 36 32 117 120 121 122 123 124 1099
1100 132 133 2 2 2 2 2 2 2 134 135 18 21 130 131 18 19 2 2 20 21 130 131 18 21 138 139 164 165 138 139 164 165 178 179 178 179 130 131 18 19 2 2 20 21 130 131 178 179 132 133 2 134 135 1070
1085 18 19 2 2 2 2 2 2 2 20 21 18 21 118 119 18 19 2 2 20 21 118 119 18 21 28 29 28 29 209 210 28 29 213 214 215 38 118 119 18 19 2 2 20 21 118 119 39 40 18 19 2 20 21 1099
1085 18 19 2 2 2 2 2 2 2 20 21 18 21 159 160 18 19 2 2 20 21 159 160 18 21 23 217 39 40 218 219 39 40 224 225 2 226 159 160 18 19 2 2 20 21 159 160 39 40 18 19 2 20 21 1085
1075 18 19 2 2 2 2 2 2 2 20 21 18 21 37 36 18 19 2 2 20 21 37 36 43 44 24 227 28 29 28 29 28 29 232 233 234 235 37 36 18 19 2 2 20 21 37 36 28 29 18 19 2 20 21 1085
1080 18 19 2 2 2 2 2 2 2 20 21 18 21 159 160 18 19 2 2 20 21 159 160 1085 1085 276 30 28 29 228 236 28 29 39 40 184 245 159 160 18 19 2 2 20 21 159 160 25 42 18 19 2 20 21 1085
1085 43 188 277 189 189 189 189 189 189 190 44 43 44 37 36 43 188 189 189 190 44 37 36 1085 1085 278 217 23 217 28 29 39 40 28 29 39 40 37 36 43 188 189 189 190 44 37 36 162 156 43 188 189 190 44 1070
1085 1094 1095 1094 1095 1094 1095 1094 1095 1094 1095 1094 1095 1094 1095 1094 1095 1094 1095 1094 1095 1094 1095 1094 1095 1085 183 40 24 227 39 40 246 247 220 221 1085 1095 1094 1095 1094 1095 1094 1095 1094 1095 1094 1095 1094 1095 1094 1095 1094 1095 1094 1099
1076 1107 1077 1076 1107 1077 1075 1073 1074 1114 1115 1108 1109 1070 1071 1072 1075 1076 1077 1073 1074 1076 1077 1076 1077 1085 183 40 27 30 39 40 249 250 228 251 1085 1073 1074 1114 1115 1108 1109 1070 1071 1072 1075 1076 1077 1073 1074 1076 1077 1073 1074 1114
1081 1110 1082 1081 1110 1082 1080 1078 1079 1090 1091 1111 1112 1099 1083 1084 1080 1125 1126 1078 1079 1081 1082 1081 1082 1070 183 40 28 29 28 29 39 40 184 185 1070 1078 1079 1090 1091 1111 1112 1099 1083 1084 1080 1125 1126 1078 1079 1081 1082 1078 1079 1090
1117 1118 1119 1117 1118 1119 1100 1122 1121 1076 1077 1117 1118 1119 1117 1118 1119 1081 1082 1122 1121 1085 1085 1076 1077 1099 147 42 170 171 22553 22570 25 42 25 42 1099 1122 1121 1076 1077 1117 1118 1119 1117 1118 1119 1081 1082 1122 1121 1085 1085 1122 1121 1076
1072 1134 1135 1076 1077 1073 1074 1076 1077 1081 1082 1076 1077 1073 1074 1076 1077 1114 1115 1134 1135 1114 1115 1081 1082 1105 21538 21538 21538 21538 21538 21538 21538 21538 21538 21538 1106 1076 1077 1081 1082 1076 1077 1073 1074 1076 1077 1114 1115 1134 1135 1114 1115 1076 1077 1081
1084 1136 1137 1125 1126 1078 1079 1081 1082 1113 1109 1125 1126 1078 1079 1081 1082 1090 1091 1136 1137 1090 1091 1114 1115 1127 1128 1123 1124 1076 1077 1127 1128 1123 1124 1076 1077 1081 1082 1113 1109 1125 1126 1078 1079 1081 1082 1090 1091 1136 1137 1090 1091 1081 1082 1113
1077 1103 1120 1081 1082 1122 1121 1085 1085 1116 1112 1081 1082 1122 1121 1085 1085 1117 1118 1119 1117 1118 1119 1090 1091 1138 1129 1092 1093 1081 1082 1138 1129 1092 1093 1081 1082 1073 1074 1116 1112 1081 1082 1076 1077 1127 1128 1123 1124 1114 1115 1118 1119 1113 1109 1116
