103 56
1073 1076 1077 1076 1077 1076 1077 1076 1077 1073 1077 1076 1077 1076 1077 1076 1077 1076 1077 1076 1077 1076 1077 1076 1077 1076 1077 1076 1077 1076 1077 1076 1077 1076 1077 1076 1077 1076 1077 1076 1077 1076 1077 1076 1077 1076 1077 1076 1078 1078 1079 1080 1081 1082 1081 1082 1083 1084 1085 1085 1086 1073 1073 1079 1080 1086 1087 1086 1087 1073 1086 1088 1087 1089 1090 1091 1078 2 2 2 2 2 2 2 1073 1090 1091 1092 1093 1094 1095 1096 1097 1094 1095 1098 1099 1100 1093 1094 1095 1096 1097
1101 130 131 16 15 16 15 16 15 16 15 16 15 130 131 1101 1101 132 133 17 16 15 130 134 135 135 135 135 135 3095 3096 135 135 3095 3096 131 16 3095 3096 15 16 3095 3096 15 16 15 3095 3096 1078 1078 1094 1095 1102 1103 1102 1103 1092 1093 1090 1091 1096 1089 1101 1094 1095 1090 1091 1096 1097 1101 1096 1104 1097 1105 1106 1107 1078 2 2 2 2 2 2 2 1089 1106 1107 1079 1080 1079 1080 1086 1088 1087 1086 1087 1079 1080 1108 1109 1110 1084 1079
1078 34 35 136 137 138 139 136 137 138 139 136 137 34 35 17 1101 38 39 140 141 142 34 143 2 2 2 2 2 3095 3096 2 2 3095 3096 35 26 3095 3096 27 26 3095 3096 27 26 27 3095 3096 1073 1073 1086 1087 1083 1084 1081 1082 1083 1084 1106 1107 1086 1087 1086 1088 1087 1106 1107 1086 1088 1087 1085 1111 1112 1113 1114 1115 1078 2 2 2 2 2 2 2 1089 1096 1097 1094 1095 1094 1095 1096 1104 1097 1096 1097 1094 1095 1098 1099 1100 1093 1094
1089 40 41 144 145 146 147 144 145 146 147 144 145 40 41 148 1101 132 133 149 150 151 40 43 2 2 2 2 2 3095 3096 2 2 3095 3096 41 152 3095 3096 153 152 3095 3096 153 152 154 3095 3096 1101 1101 1096 1097 1092 1093 1102 1103 1092 1093 1114 1115 1096 1097 1096 1104 1097 1114 1115 1096 1104 1097 49 50 51 49 1086 1087 1078 2 2 2 2 2 2 2 1105 1085 1111 1112 1078 1085 1111 1112 1078 1085 1111 1112 1078 1085 1111 1112 1078 32825 32826
1105 155 156 157 33 157 33 157 33 157 33 157 33 40 41 158 1101 159 160 161 45 33 40 43 2 2 2 2 2 3095 3096 2 2 3095 3096 41 162 3095 3096 163 162 3095 3096 163 162 164 3095 3096 1078 1078 1086 1087 1116 1117 1118 1119 1116 1117 1118 1119 1120 1121 1079 1080 1113 50 51 1085 1111 1112 1101 1122 1123 1101 1096 1097 1089 165 166 15 16 15 16 15 1113 1076 1077 1076 1077 1076 1077 1076 1077 1076 1077 1076 1077 1076 1077 1076 1113 32846 32847
1105 130 131 1078 1077 1076 1077 1076 1077 1076 1077 1076 1078 40 41 167 1078 168 169 1089 1078 1089 40 43 2 2 2 2 2 3095 3096 2 2 3095 3096 41 170 171 172 173 170 3095 3096 173 170 171 3095 3096 1078 1078 1096 1097 1124 1125 1126 1127 1124 1125 1126 1127 1128 1129 1094 1095 1085 1122 1123 1086 1087 1073 1086 1088 1087 1089 1090 1091 1078 174 175 27 26 27 26 27 16 176 15 16 15 130 131 16 15 16 15 16 168 169 132 133 1113 1086 1087
1130 21538 21539 1131 1089 1074 1075 1108 1108 1086 1087 1101 1101 40 41 167 1089 38 39 1105 1078 1105 40 43 2 2 2 2 2 3095 3096 2 2 2 177 41 20 19 178 179 20 19 178 179 20 19 3095 3096 1073 1073 1079 1080 1086 1087 1079 1080 1086 1087 1083 1084 1085 1111 1112 1078 1079 1080 1089 1096 1097 1101 1096 1104 1097 1105 1106 1107 1078 180 181 19 20 19 20 19 26 175 27 26 27 34 35 26 27 26 27 26 159 160 38 39 1073 1096 1097
1101 40 41 1078 1105 1122 1123 1098 1098 1096 1097 182 15 40 41 167 1105 132 133 1113 1089 1089 40 43 2 2 2 2 2 3095 3096 2 2 2 177 41 20 19 20 19 20 19 42 183 184 185 3095 3096 1101 1101 1094 1095 1096 1097 1094 1095 1096 1097 1092 1093 1086 1087 1079 1080 1094 1095 1105 1086 1088 1087 1085 1111 1112 1113 1114 1115 1078 180 181 186 187 19 20 19 20 181 19 20 19 40 41 20 19 20 19 20 132 133 168 169 1101 1110 1084
1073 40 41 1089 1113 1090 1091 1132 1133 1083 1084 188 27 40 41 167 1113 38 39 1078 1105 1105 40 43 2 2 2 2 2 3095 3096 2 2 2 177 41 20 19 20 19 20 19 20 19 20 19 3095 3096 1073 1078 1086 1087 1086 1087 1086 1087 1079 1080 1086 1087 1096 1097 1094 1095 1086 1087 1113 1096 1104 1097 49 50 51 49 1086 1087 1078 180 181 189 190 19 20 19 20 181 19 20 19 40 41 191 192 193 194 195 159 160 38 39 1078 1100 1093
1101 40 41 1105 1089 1106 1107 1134 1135 1092 1093 18 19 40 41 149 1089 132 133 1073 1089 1113 40 43 2 2 2 2 2 3095 3096 2 2 2 177 41 32897 32897 32897 32897 32897 19 196 197 198 199 3095 3096 1101 1078 1096 1097 1096 1097 1096 1097 1094 1095 1096 1097 1120 1121 1086 1087 1096 1097 1113 1085 1111 1112 1101 1122 1123 1101 1096 1097 1089 200 201 31 30 31 30 31 30 201 31 30 31 40 41 202 203 204 205 206 168 169 132 133 1089 1118 1119
1078 40 41 1113 1105 1086 1087 1074 1075 1086 1087 18 19 21540 21541 21541 1131 159 160 1101 1105 1078 40 43 2 2 2 2 2 2 2 2 2 2 177 41 26 27 26 27 26 19 207 208 47 48 20 19 1136 1076 1077 1076 1078 1087 1086 1087 1078 1085 1111 1112 1128 1129 1096 1097 1085 1085 1085 1086 1087 1073 1086 1088 1087 1089 1090 1091 1105 209 210 33 45 33 45 33 45 211 33 45 33 155 156 212 213 214 215 216 159 160 38 39 1105 1126 1127
1089 40 41 1073 1089 1096 1097 1122 1123 1096 1097 18 19 40 41 1089 1089 168 169 1073 1113 1073 40 43 2 2 2 2 2 2 2 2 2 2 177 41 32897 32897 32897 32897 32897 19 20 19 20 19 20 19 16 15 16 15 1078 1097 1096 1097 1086 1087 1079 1080 1120 1121 1081 1082 1083 1084 1089 1096 1097 1101 1096 1104 1097 1105 1106 1107 1113 1078 1085 1076 1077 1076 1077 1076 1077 1076 1077 1076 1077 1076 1077 1076 1077 1076 1077 1073 168 169 132 133 1113 1086 1087
1105 40 41 1101 1105 1083 1084 1086 1087 1132 1133 18 19 40 41 16 15 38 39 1101 1078 1101 40 43 2 2 2 2 2 2 2 2 2 2 177 41 11290 11291 11290 11291 11290 19 42 29 20 19 42 29 217 218 1137 1138 1078 1087 1079 1080 1096 1097 1094 1095 1128 1129 1102 1103 1092 1093 1105 1086 1088 1087 1085 1111 1112 1113 1114 1115 1085 1085 1111 1112 1078 1085 1111 1112 1078 1085 1111 1112 1078 1085 1111 1118 1119 1116 1117 1101 38 39 38 39 1101 1096 1097
1113 40 41 1078 1113 1092 1093 1096 1097 1134 1135 18 19 40 41 219 220 132 133 1101 1073 1089 40 43 2 2 2 2 2 2 2 2 2 2 177 41 32897 32897 32897 32897 32897 19 42 29 20 19 42 29 144 145 221 222 1078 1097 1094 1095 1118 1119 1078 1085 1085 1078 1085 1078 1085 1085 1113 1096 1104 1097 49 50 51 49 1086 1087 1078 1078 1076 1077 1076 1077 1076 1077 1076 1077 1076 1077 1076 1077 1089 1126 1127 1124 1125 1073 132 133 132 133 1078 1090 1091
1073 40 41 1089 1089 1074 1075 1108 1108 1086 1087 18 19 40 41 223 224 38 39 1073 1101 1105 40 43 2 2 2 2 2 2 2 2 2 2 177 41 26 27 26 27 26 19 20 19 20 19 42 29 157 33 45 33 1073 1087 1086 1087 1126 1127 1086 1087 1081 1082 1081 1082 1083 1084 1086 1087 1111 1112 1101 1122 1123 1101 1096 1097 1089 1078 130 131 16 15 159 160 38 39 16 15 130 131 1113 1077 1076 1077 1073 1101 159 160 38 39 1073 1106 1107
1101 40 41 1105 1105 1122 1123 1098 1098 1096 1097 18 19 155 156 157 33 132 133 1101 1073 1089 40 43 2 2 2 2 2 2 2 2 2 2 177 41 184 185 20 19 42 29 20 19 20 19 20 19 1139 1076 1140 1141 1101 1097 1096 1097 1078 1085 1096 1097 1102 1103 1102 1103 1092 1093 1096 1097 1090 1091 1085 1111 1112 1078 1111 1112 1105 1078 34 35 26 27 168 169 168 169 26 27 34 35 16 15 16 15 1101 1078 168 169 168 169 1101 1114 1115
1078 40 41 1113 1101 1073 1089 1101 1073 1089 1130 21541 21541 21541 21541 1131 1077 1076 1077 1078 1101 1105 40 43 2 2 2 2 2 2 2 2 2 2 177 41 198 199 20 19 20 19 225 226 20 19 20 19 1078 1078 1086 1087 1086 1087 1086 1087 1118 1119 1085 1078 1118 1119 1118 1119 1116 1117 1086 1087 1106 1107 1110 1084 1086 1087 1086 1087 1113 1078 40 41 184 185 38 39 38 39 20 19 40 41 26 27 1137 1138 1078 1078 38 39 38 39 1078 1086 1087
1073 155 156 1101 1077 1078 1074 1075 1108 1108 1086 1087 1086 1087 1078 1074 1075 1132 1133 1108 1108 1113 22568 22571 2 2 2 2 2 2 2 2 2 2 177 41 47 48 20 19 20 19 227 228 20 19 20 19 1078 1078 1096 1097 1096 1097 1096 1097 1126 1127 1079 1080 1126 1127 1126 1127 1124 1125 1096 1097 1114 1115 1100 1093 1096 1097 1096 1097 1078 1089 40 41 198 199 168 169 132 133 229 230 40 41 30 31 221 222 1078 1089 168 169 132 133 1089 1096 1097
1101 130 131 3095 3096 1073 1122 1123 1098 1098 1096 1097 1096 1097 1089 1122 1123 1134 1135 1098 1098 1078 155 231 44 44 44 44 44 22572 22572 44 44 44 232 156 20 19 20 19 20 19 20 19 22548 22547 20 19 1078 1086 1087 1086 1087 1086 1087 1105 1083 1084 1094 1095 1096 1097 1079 1080 1086 1087 1086 1087 1086 1087 1079 1080 1086 1087 1120 1121 1089 1105 155 156 47 48 38 39 159 160 233 234 155 156 45 33 157 33 1073 1105 38 39 159 160 1105 1110 1084
1078 34 35 3095 3096 1101 1132 1133 1086 1087 1086 1087 1090 1091 1108 1090 1091 1086 1087 1108 1108 1130 21541 21541 21541 21541 21541 21541 21541 21541 21541 21541 21541 21541 21541 21541 21541 21541 21541 21541 21541 21541 21541 21541 21541 21541 21541 21541 1131 1096 1097 1096 1097 1096 1097 1113 1092 1093 1086 1087 1079 1080 1094 1095 1096 1097 1096 1097 1096 1097 1094 1095 1096 1097 1128 1129 1105 1113 1077 1076 46 31 168 169 132 133 30 31 1073 1077 1076 1078 1140 1141 1101 1113 132 133 168 169 1113 1100 1093
1078 40 41 3095 3096 1078 1134 1135 1096 1097 1096 1097 1106 1107 1098 1106 1107 1096 1097 1098 1098 1077 1076 1077 1076 1077 1076 1077 1076 1077 1076 1077 1076 1077 1076 1078 1038 1039 1040 1039 1041 1078 1077 1076 1077 1076 1077 1076 1078 1108 1108 1083 1084 1086 1087 1110 1086 1087 1096 1097 1094 1095 1086 1087 1079 1080 1086 1087 1079 1080 1086 1087 1087 1110 1084 1086 1087 1110 1084 1142 22573 22561 38 39 159 160 22573 22561 1120 1121 1086 1087 1118 1119 1073 1113 159 160 38 39 1078 1118 1119
1089 40 41 3095 3096 1078 1090 1091 1086 1087 1108 1108 1114 1115 1143 1142 1090 1091 1142 1113 1142 1143 1142 1085 1111 1143 1142 1143 1142 1143 1142 1085 1111 1143 1142 1089 188 27 26 27 148 1073 1143 1142 1085 1111 1143 1142 1078 1098 1098 1092 1093 1096 1097 1100 1096 1097 1085 1078 1086 1087 1096 1097 1094 1095 1096 1097 1094 1095 1096 1097 1097 1100 1093 1096 1097 1100 1093 1142 1142 1089 132 133 168 169 1089 1142 1128 1129 1096 1097 1126 1127 1101 1078 168 169 132 133 1073 1126 1127
1105 40 41 3095 3096 1089 1106 1107 1096 1097 1098 1098 1108 1108 1086 1087 1106 1107 1108 1086 1087 1078 1074 1075 1108 1108 1108 1074 1075 1108 1108 1086 1087 1083 1084 1105 18 19 20 19 158 1073 1074 1075 1108 1108 1086 1087 1083 1084 1074 1075 1108 1108 1086 1087 1083 1084 1074 1075 1108 1108 1074 1075 1108 1108 1086 1087 1083 1084 1078 1086 1087 1081 1082 1086 1087 1081 1082 1118 1119 1089 159 160 38 39 1078 1078 1118 1119 1116 1117 1081 1082 1116 1117 159 160 38 39 1078 1086 1087
1113 40 41 3095 3096 1105 1114 1115 1144 1145 1144 1145 1098 1098 1096 1097 1114 1115 1098 1096 1097 1089 1122 1123 1098 1098 1098 1122 1123 1098 1098 1096 1097 1092 1093 1113 18 19 20 19 167 1073 1122 1123 1098 1098 1096 1097 1092 1093 1122 1123 1098 1098 1096 1097 1092 1093 1122 1123 1098 1098 1122 1123 1098 1098 1096 1097 1092 1093 1078 1096 1097 1102 1103 1096 1097 1102 1103 1126 1127 1105 168 169 132 133 1078 1078 1126 1127 1124 1125 1102 1103 1124 1125 168 169 168 169 1078 1096 1097
1089 40 41 3095 3096 1078 1090 1091 1086 1087 1108 1108 1114 1115 1143 1142 1090 1091 1142 1113 1142 1143 1142 1085 1111 1143 1142 1143 1142 1143 1142 1085 1111 1143 1142 1089 18 19 20 19 167 1073 2069 2070 1077 1076 1077 1076 1077 1076 1077 1076 1077 1076 1077 1076 1077 1076 1077 1076 1077 1073 1073 1076 1077 1076 1077 1076 1077 1076 1078 1110 1084 1074 1075 1110 1084 1074 1075 1108 1087 1113 159 160 38 39 1089 1073 1086 1087 1083 1084 1086 1087 1083 1084 159 160 38 39 1089 1090 1091
1105 40 41 3095 3096 1089 1106 1107 1096 1097 1098 1098 1108 1108 1086 1087 1106 1107 1108 1086 1087 1078 1077 1130 21541 21541 21541 21541 21541 21541 21541 21541 21541 21541 1131 1105 18 19 20 19 158 16 3095 3096 134 135 135 135 3095 3096 135 135 135 135 135 235 131 15 16 15 10257 236 237 17 16 15 16 15 16 15 1078 1100 1093 1122 1123 1100 1093 1122 1123 1098 1097 1105 168 169 132 133 1078 1078 1096 1097 1092 1093 1096 1097 1092 1093 168 169 168 169 1105 1106 1107
1113 40 41 3095 3096 1105 1114 1115 1144 1145 1120 1145 1098 1098 1096 1097 1114 1115 1098 1096 1097 1089 182 15 38 39 38 39 38 39 38 39 38 39 1105 1113 18 19 20 19 167 26 3095 3096 143 2 2 2 3095 3096 2 2 2 2 2 238 35 1113 1113 1101 239 240 241 148 26 27 26 27 26 27 1078 1118 1119 1116 1117 1118 1119 1116 1117 1086 1087 1113 159 160 38 39 1089 1073 1101 1076 1077 1076 1077 1076 1077 1130 21542 21543 21542 21543 1131 1114 1115
1113 40 41 3095 3096 1113 1146 1087 1147 1148 1128 1148 1078 1073 1076 1077 1076 1077 1076 1077 1076 1073 188 27 132 133 132 133 132 133 132 133 132 133 1113 1113 18 186 187 19 167 20 3095 3096 43 2 2 2 3095 3096 2 2 2 2 2 177 41 1113 242 27 243 244 245 158 20 19 20 19 20 19 1078 1126 1127 1124 1125 1126 1127 1124 1125 1149 1150 1113 168 169 168 169 1105 1101 14 15 16 15 16 15 16 15 132 133 132 133 1078 1086 1087
1078 40 41 3095 3096 1113 1096 1097 1143 1142 1085 1111 1112 246 16 15 16 15 16 15 16 15 46 31 38 39 159 160 38 39 159 160 38 39 247 248 249 189 190 19 167 20 3095 3096 43 2 2 2 3095 3096 2 2 2 2 2 177 41 1113 1113 1101 250 244 245 167 20 19 152 154 251 153 1089 1086 1087 1083 1084 1086 1087 1083 1084 1096 1097 1101 38 39 38 39 1113 1101 252 253 26 27 254 255 26 27 159 160 38 39 1089 1096 1097
1073 40 41 3095 3096 1101 1076 1077 1076 1077 1076 1077 1073 256 26 27 26 27 26 27 26 27 157 33 132 133 168 169 132 133 168 169 132 133 1078 1078 18 19 184 185 167 196 3095 3096 43 2 2 2 3095 3096 2 2 2 2 2 177 41 1113 242 27 25 244 245 167 20 19 162 164 2 163 1105 1096 1097 1092 1093 1096 1097 1092 1093 1081 1082 1078 168 169 132 133 1113 1101 257 258 259 260 20 19 20 19 132 133 168 169 1101 1110 1084
1078 40 41 3095 3096 38 39 38 39 38 39 38 39 243 20 19 42 29 20 19 20 19 4119 4120 1078 1077 1076 1077 1076 1077 1078 182 15 17 1078 1101 1077 1076 261 199 167 262 263 40 43 2 2 2 3095 3096 2 2 2 2 2 177 41 1113 1113 1101 250 244 245 167 30 264 170 171 172 173 1113 1090 1091 1086 1087 1090 1091 1086 1087 1102 1103 1078 38 39 159 160 16 15 20 19 20 19 20 19 20 19 159 160 38 39 1078 1100 1093
1073 40 41 16 15 132 133 132 133 132 133 132 133 167 20 265 184 185 20 19 20 19 3095 3096 1073 1073 1120 1121 1086 1087 1073 188 27 148 16 15 242 27 266 267 167 268 269 40 43 2 2 2 3095 3096 2 2 2 2 2 177 41 3095 3096 27 10265 244 245 167 32 33 18 19 20 19 1113 1106 1107 1149 1150 1106 1107 1149 1150 1086 1087 1089 132 133 168 169 26 27 20 19 20 19 20 19 20 19 168 169 132 133 1078 1118 1119
1101 40 41 254 255 38 39 159 160 38 39 159 160 167 270 271 198 199 270 272 259 260 3095 3096 1101 1101 1128 1129 1096 1097 1101 18 19 158 273 274 249 186 187 19 167 20 19 40 43 2 2 2 3095 3096 2 2 2 2 2 177 41 3095 3096 19 167 244 245 167 1078 1078 1042 1043 1044 1043 1101 1114 1115 1096 1097 1114 1115 1096 1097 1096 1097 1105 159 160 38 39 20 19 20 19 259 260 20 19 20 19 38 39 38 39 1089 1126 1127
1078 155 156 233 234 132 133 168 169 132 133 168 169 167 259 275 47 48 259 260 276 265 3095 3096 1078 1073 1086 1087 1086 1087 1078 18 19 167 20 277 20 189 190 19 167 20 19 40 43 2 2 2 3095 3096 2 2 2 2 2 177 41 3095 3096 226 167 244 245 167 1101 1130 21541 21541 21541 21541 1131 1116 1117 1089 1118 1119 1116 1117 1074 1075 1089 1113 168 169 132 133 259 260 20 19 259 260 20 19 20 19 132 133 132 133 1105 1086 1087
1078 130 131 178 278 1101 1076 1077 1076 1077 1076 1077 1073 250 259 19 20 19 259 260 279 271 3095 3096 1078 1101 1090 1091 1096 1097 1078 18 19 167 225 226 20 19 20 19 167 259 260 40 43 2 2 2 3095 3096 2 2 2 2 2 177 41 3095 3096 228 167 244 245 167 1073 1078 18 19 20 19 1078 1124 1125 1105 1126 1127 1124 1125 1122 1123 1105 1101 159 160 38 39 20 19 20 19 20 19 32897 32897 32897 32897 38 39 38 39 1078 1096 1097
1105 40 41 42 29 1073 1086 1087 1110 1084 1086 1087 1073 250 178 19 20 19 178 280 281 275 3095 3096 1078 1073 1106 1107 1110 1084 1073 18 19 167 227 228 259 260 20 19 167 282 283 22568 22571 2 2 2 3095 3096 2 2 2 2 2 177 41 3095 3096 284 167 244 245 167 1101 1073 18 19 42 183 1089 1110 1084 1086 1087 1086 1087 1079 1080 1113 1085 1078 132 133 168 169 20 19 20 19 20 19 26 27 26 285 168 169 132 133 1078 1111 1105
1130 21544 21545 21546 21533 1131 1090 1091 1100 1093 1096 1097 1105 286 30 31 30 31 30 31 30 31 1101 1078 1078 1101 1114 1115 1100 1093 1101 18 19 167 229 230 178 280 229 230 167 268 269 40 43 2 2 2 3095 3096 2 2 2 1076 1077 177 41 3095 3096 287 167 244 245 167 1078 1101 18 19 20 19 1105 1100 1093 1096 1097 1096 1097 1094 1095 1086 1088 1078 159 160 38 39 288 31 30 31 30 31 30 31 30 31 38 39 38 39 1089 1112 1113
1105 40 41 42 29 1073 1106 1107 1086 1087 1086 1087 1130 21541 21541 21541 21541 21541 21541 21541 21541 21541 1131 1143 1086 1087 1083 1084 1079 1080 1073 22574 22559 149 289 290 30 31 289 290 149 30 31 40 43 2 2 2 3095 3096 2 2 2 2 2 177 41 149 30 264 149 244 245 149 1101 1073 18 19 20 19 1113 1079 1080 1086 1087 1120 1121 1086 1087 1096 1104 1089 168 169 132 133 45 33 45 33 32 33 32 33 32 33 132 133 132 133 1105 51 49
1105 40 41 184 185 1073 1114 1115 1096 1097 1096 1097 1078 1078 1077 1076 1077 1076 1077 1076 1077 1076 1078 1078 1096 1097 1092 1093 1094 1095 1101 291 33 161 157 33 32 33 157 33 161 32 33 155 231 44 44 44 44 44 44 44 44 44 44 232 156 161 32 33 161 244 245 161 1078 1078 18 19 20 19 1078 1094 1095 1096 1097 1128 1129 1096 1097 1085 1111 1105 1076 1077 1076 1077 1076 1077 1076 1077 1076 1077 1076 1077 1076 1077 1076 1077 1076 1077 1078 1123 1101
1105 40 41 42 29 1105 1086 1087 1110 1084 1120 1121 1086 1087 1110 1084 1120 1121 1086 1087 1079 1080 1110 1084 1120 1121 1086 1087 1079 1080 1130 21541 21541 21541 21541 21541 22565 22565 21541 21541 21541 21541 21541 21541 21541 21541 21541 21541 21541 21541 21541 21541 21541 21541 21541 21541 21541 21541 21541 21541 21541 21541 21541 21541 1131 1073 18 19 42 183 1089 1077 1076 1077 1101 1078 1078 1101 1078 1078 1116 1117 1089 1118 1119 1116 1117 1089 1086 1087 1116 1117 1078 1118 1119 1116 1117 1073 1074 1075 1074 1075 1085
1105 40 41 184 185 1073 1096 1097 1100 1093 1128 1129 1096 1097 1100 1093 1128 1129 1096 1097 1094 1095 1100 1093 1128 1129 1096 1097 1094 1095 1073 1076 1077 1076 1077 1076 1077 1076 1077 1076 1077 1076 1077 1076 1077 1076 1077 1076 1077 1076 1077 1076 1077 1076 1077 1076 1077 1076 1077 1076 1077 1076 1077 1076 1113 1142 18 19 20 19 16 15 16 15 1101 1079 1080 1101 1086 1087 1124 1125 1105 1126 1127 1124 1125 1105 1090 1091 1124 1125 1105 1126 1127 1124 1125 1101 1122 1123 1122 1123 1086
1113 40 41 198 199 1101 1078 1078 1078 1118 1119 1116 1117 1120 1121 1086 1087 1079 1080 1079 1080 1120 1121 1118 1119 1116 1117 1101 1118 1119 1116 1117 1118 1119 1120 1121 1118 1119 1116 1117 1101 1086 1087 1079 1080 1120 1121 1086 1087 1079 1080 1086 1087 1086 1087 1079 1080 1079 1080 1086 1087 1086 1087 1079 1080 1073 18 19 20 19 26 27 26 27 1078 1094 1095 1078 1096 1097 1078 1078 1078 1078 1078 1078 1078 1113 1106 1107 1079 1080 1113 1086 1087 1083 1084 1078 1078 1078 1086 1087 1149
1113 40 41 22575 22576 1078 1077 1076 1073 1126 1127 1124 1125 1128 1129 1096 1097 1094 1095 1094 1095 1128 1129 1126 1127 1124 1125 1078 1126 1127 1124 1125 1126 1127 1128 1129 1126 1127 1124 1125 1078 1096 1097 1094 1095 1128 1129 1096 1097 1094 1095 1096 1097 1096 1097 1094 1095 1094 1095 1096 1097 1096 1097 1094 1095 1073 18 19 42 183 20 19 20 19 1078 1086 1087 1101 1086 1087 1116 1117 1078 1118 1119 1116 1117 1089 1114 1115 1094 1095 1089 1096 1097 1092 1093 1073 1083 1084 1096 1097 1096
1078 40 41 259 260 16 15 17 1136 1076 1077 1076 1073 1101 1101 1086 1087 1079 1080 1079 1080 1086 1087 1086 1087 1079 1080 1086 1087 1086 1087 1086 1087 1089 1079 1080 1086 1087 1086 1087 1079 1080 1101 1076 1077 1076 1077 1076 1078 1076 1077 1078 1143 1142 1078 1073 1077 1076 1077 1076 1077 1076 1077 1076 1101 1101 18 19 20 19 20 19 20 19 1101 1096 1097 1101 1090 1091 1124 1125 1105 1126 1127 1124 1125 1105 1078 1078 1078 1078 1078 1078 1078 1085 1111 1101 1092 1093 1079 1080 1086
1073 40 41 20 19 26 27 148 16 15 16 15 1101 1079 1080 1096 1097 1094 1095 1094 1095 1096 1097 1096 1097 1094 1095 1096 1097 1096 1097 1096 1097 1105 1094 1095 1096 1097 1096 1097 1094 1095 1078 182 15 16 15 16 15 17 1073 1085 1073 1073 182 15 16 15 16 15 16 15 16 15 16 15 249 19 20 19 20 19 20 19 1078 1086 1087 1078 1106 1107 1079 1080 1113 1086 1087 1083 1084 1113 1076 1077 1076 1077 1076 1077 1076 1077 1076 1077 1076 1078 1094 1095 1090
1101 40 41 259 260 20 19 158 217 218 1137 1138 1078 1094 1095 1120 1121 1086 1087 1086 1087 1079 1080 1120 1121 1086 1087 1079 1080 1120 1121 1086 1087 1113 1086 1087 1079 1080 1120 1121 1086 1087 1078 188 27 26 27 217 218 148 1137 1138 1101 1101 292 218 26 253 26 27 26 27 26 27 26 27 20 2069 2070 250 42 29 259 260 1078 1090 1091 1078 1114 1115 1094 1095 1089 1096 1097 1092 1093 1089 130 134 135 135 135 135 235 293 17 1137 1138 1078 1086 1087 1106
1078 40 41 20 19 196 197 167 144 145 221 222 1078 1086 1087 1128 1129 1096 1097 1096 1097 1094 1095 1128 1129 1096 1097 1094 1095 1128 1129 1090 1091 1089 1096 1097 1094 1095 1128 1129 1096 1097 1073 18 19 259 260 144 145 149 221 222 1073 1078 294 145 30 31 30 31 30 31 295 296 297 298 20 3095 3096 299 152 154 251 153 1073 1106 1107 1073 1086 1087 1083 1084 1105 1118 1119 1116 1117 1105 34 143 2 2 2 2 238 35 300 221 222 1073 1096 1097 1114
1078 40 41 270 272 207 208 167 157 33 45 33 1073 1096 1097 1086 1087 1086 1087 1120 1121 1086 1087 1083 1084 1120 1121 1086 1087 1083 1084 1106 1107 1105 1120 1121 1086 1087 1083 1084 1074 1075 1101 18 19 42 29 157 33 161 157 33 1101 1078 1077 1076 1077 1076 1077 1076 1077 1076 301 2 2 302 20 3095 3096 19 162 164 2 163 1101 1114 1115 1101 1096 1097 1092 1093 1089 1126 1127 1124 1125 1113 40 43 2 2 2 2 177 41 303 157 33 1101 1086 1087 1086
1089 40 41 259 260 229 230 167 1139 1076 1140 1141 1101 1086 1087 1090 1091 1096 1097 1128 1129 1096 1097 1092 1093 1128 1129 1096 1097 1092 1093 1114 1115 1113 1128 1129 1096 1097 1092 1093 1122 1123 1078 18 19 20 19 1073 1077 1076 1140 1141 1076 1077 1073 1101 1073 1073 1073 1073 1101 1136 301 2 2 304 20 3095 3096 19 170 171 172 173 1136 1076 1077 1076 1077 1076 1077 1076 1077 1076 1077 1076 1077 1089 40 43 2 2 2 2 177 41 1078 1140 1141 1078 1090 1091 1096
1105 40 41 259 260 305 306 158 1101 1078 1078 1073 1078 1096 1097 1106 1107 1110 1084 1086 1087 1086 1087 1086 1087 1086 1087 1086 1087 1086 1087 1073 1079 1080 1086 1087 1086 1087 1086 1087 1086 1087 1073 18 19 20 19 130 134 135 135 135 235 131 16 15 16 15 1101 246 16 15 12316 307 308 309 20 19 20 19 20 19 20 12307 16 15 17 16 15 16 15 16 15 38 39 17 38 39 40 43 2 2 2 2 177 41 1078 1077 1076 1078 1106 1107 1110
1113 155 156 310 311 30 31 149 1078 1086 1088 1087 1078 1110 1084 1114 1115 1100 1093 1090 1091 1096 1097 1090 1091 1090 1091 1096 1097 1090 1091 1101 1094 1095 1090 1091 1096 1097 1090 1091 1096 1097 1101 18 19 42 29 34 43 2 2 2 177 35 26 27 26 27 312 27 26 27 12308 19 313 314 20 19 20 19 20 19 42 12317 26 27 148 273 274 26 27 26 27 132 133 148 132 133 40 43 2 2 2 2 177 41 1073 1078 1086 1087 1114 1115 1100
1130 22565 22565 21541 21541 21541 21541 21541 1131 1096 1104 1097 1078 1100 1093 1078 1078 1073 1143 1106 1107 1110 1084 1106 1107 1106 1107 1110 1084 1106 1107 1086 1088 1087 1106 1107 1110 1084 1106 1107 1110 1084 1073 46 31 30 31 40 43 2 2 2 177 41 30 31 30 31 30 31 30 31 12318 31 30 31 30 31 30 31 30 31 30 12319 30 31 149 288 264 30 31 30 31 38 39 149 38 39 40 43 2 2 2 2 177 41 1101 1105 1096 1097 1118 1119 1116
1078 1076 1077 1076 1077 1076 1077 1076 1078 1086 1087 1118 1119 1116 1117 1118 1119 1116 1117 1114 1115 1100 1093 1114 1115 1114 1115 1100 1093 1114 1115 1096 1104 1097 1114 1115 1100 1093 1114 1115 1100 1093 1101 315 33 45 33 155 231 44 44 44 232 156 32 33 32 33 32 33 32 33 12320 33 32 33 32 33 32 33 32 33 32 12321 32 33 161 32 33 32 33 32 33 132 133 303 132 133 155 231 44 44 44 44 232 156 1101 1113 1086 1087 1126 1127 1124
1086 1087 1086 1087 1086 1087 1078 1078 1078 1096 1097 1126 1127 1124 1125 1126 1127 1124 1125 1073 1151 1089 1079 1080 1086 1152 1086 1088 1087 316 1086 1088 1087 1089 1079 1080 1086 1087 1079 1080 1086 1087 1111 1076 1077 1076 1077 1076 1077 1076 1077 1076 1077 1076 1077 1076 1077 1076 1077 1076 1077 1139 1077 1076 1077 1076 1077 1076 1077 1076 1077 1076 1077 1076 1139 1076 1077 1076 1077 1076 1077 1076 1077 1076 1077 1076 1077 1130 21541 21541 21541 22565 22565 21541 21541 21541 1131 1078 1096 1097 1078 1078 1078
1096 1097 1090 1091 1096 1097 1086 1087 1086 1088 1087 1086 1088 1087 1086 1088 1087 1086 1087 1101 1089 1105 1094 1095 1096 1089 1096 1104 1097 317 1096 1104 1097 1105 1094 1095 1096 1097 1094 1095 1096 1097 1086 1087 1086 1087 1089 1079 1080 1086 1087 1086 1087 1089 1079 1080 1086 1087 1113 1086 1087 1079 1080 1086 1087 1083 1084 1079 1080 1086 1087 1083 1084 1079 1080 1086 1087 1086 1087 1078 1079 1080 1086 1087 1083 1084 1079 1080 1086 1087 1083 1084 1079 1080 1086 1087 1086 1087 1079 1080 1086 1087 1086
1110 1084 1106 1107 1110 1084 1096 1097 1096 1104 1097 1096 1104 1097 1096 1104 1097 1096 1097 1086 1087 1113 1086 1087 1079 1087 1086 1087 1089 1079 1080 1086 1087 1113 1086 1087 1079 1080 1086 1087 1079 1080 1096 1097 1096 1097 1105 1094 1095 1096 1097 1096 1097 1105 1094 1095 1096 1097 1089 1096 1097 1094 1095 1096 1097 1092 1093 1094 1095 1096 1097 1092 1093 1094 1095 1096 1097 1096 1097 1078 1094 1095 1096 1097 1092 1093 1094 1095 1096 1097 1092 1093 1094 1095 1096 1097 1096 1097 1094 1095 1096 1097 1096
