20 15
0 1 2 3 3 4 5 6 7 8 3 9 3 3 3 3 10 3 3 3
11 12 13 12 3 3 14 15 16 17 3 18 3 19 20 21 3 3 22 3
3 3 3 3 3 3 23 24 25 26 3 27 28 29 30 3 31 3 3 3
32 33 34 3 35 3 36 37 38 39 40 3 41 3 42 3 3 43 3 3
44 45 46 47 48 49 50 51 52 53 54 46 47 48 55 56 57 58 46 47
59 60 59 60 61 62 63 64 65 66 67 59 60 61 68 69 70 71 59 60
72 73 72 73 74 75 76 77 78 79 80 81 82 83 84 85 86 87 88 89
90 91 90 91 92 93 94 95 96 97 98 99 100 101 102 103 104 105 106 107
108 109 108 109 110 111 112 113 114 115 116 89 117 118 119 120 121 122 123 124
125 125 125 125 126 127 128 129 130 131 132 133 134 135 136 137 138 139 140 141
125 125 125 125 125 125 125 125 125 125 142 125 125 143 144 145 125 146 147 148
125 125 125 125 125 125 125 125 125 125 125 125 125 125 125 125 125 125 125 125
125 125 125 125 125 125 125 125 125 125 125 125 125 125 125 125 125 125 125 125
125 125 125 125 125 125 125 125 125 125 125 125 125 125 125 125 125 125 125 125
125 125 125 125 125 125 125 125 125 125 125 125 125 125 125 125 125 125 125 125
