20 15
0 0 0 0 0 0 0 0 0 0 0 0 0 0 0 0 0 0 0 0
0 0 0 0 0 0 0 0 0 0 0 0 0 0 0 0 0 0 0 0
0 0 0 0 0 0 0 0 0 0 0 0 0 0 0 0 0 0 0 0
0 0 0 0 0 0 0 0 0 0 0 0 0 0 0 0 0 0 0 0
0 0 0 0 0 1 2 3 4 0 0 0 5 0 0 6 0 0 0 0
0 0 0 7 8 9 10 11 12 13 14 15 16 17 18 19 0 0 0 0
0 0 0 20 0 21 0 22 23 24 25 26 27 28 29 0 0 0 0 0
0 0 0 0 0 30 31 32 33 34 35 36 37 0 38 0 0 0 0 0
0 0 0 0 39 40 41 42 43 0 44 45 0 46 47 0 0 0 0 0
0 0 0 48 49 50 0 0 0 0 0 0 0 0 51 0 0 0 0 0
0 0 0 0 0 0 0 0 0 0 0 0 0 0 0 0 0 0 0 0
0 0 0 0 0 0 0 0 0 0 0 0 0 0 0 0 0 0 0 0
0 0 0 0 0 0 0 0 0 0 0 0 0 0 0 0 0 0 0 0
0 0 0 0 0 0 0 0 0 0 0 0 0 0 0 0 0 0 0 0
