20 14
0 0 0 0 0 0 0 0 0 0 0 0 0 0 0 0 0 0 0 0
0 0 0 0 0 0 0 0 0 0 0 0 0 0 0 0 0 0 0 0
0 0 0 0 0 0 0 0 0 0 0 0 0 0 0 0 0 0 0 0
0 0 0 0 0 0 0 0 0 0 0 0 0 0 0 0 0 0 0 0
0 0 0 0 0 1 2 0 3 4 5 6 7 8 0 0 0 0 0 0
0 0 0 0 9 10 11 12 13 14 15 16 17 18 19 0 0 0 0 0
0 0 0 0 20 21 22 23 24 25 26 27 28 29 30 31 32 0 0 0
0 0 33 34 0 35 36 37 38 39 40 41 42 43 44 45 46 47 48 0
0 49 50 51 0 52 53 54 55 56 57 58 59 60 61 62 63 64 65 0
0 0 0 0 0 0 0 66 67 68 69 70 71 72 73 74 75 76 77 0
0 0 0 0 0 0 0 0 0 0 78 0 0 0 79 80 81 0 0 0
0 0 0 0 0 0 0 0 0 0 0 0 0 0 0 0 0 0 0 0
0 0 0 0 0 0 0 0 0 0 0 0 0 0 0 0 0 0 0 0
0 0 0 0 0 0 0 0 0 0 0 0 0 0 0 0 0 0 0 0
