144 24
102 102 102 102 102 102 102 102 102 102 102 103 104 102 102 102 102 102 102 102 102 102 102 102 102 102 102 102 102 102 105 106 107 108 102 102 102 102 109 1 2 102 102 102 102 102 110 111 106 0 102 102 102 102 102 102 102 112 0 0 0 3073 3074 113 112 0 0 0 0 0 0 0 0 0 0 0 0 0 0 0 0 0 0 0 0 0 0 0 0 0 0 0 0 0 0 0 105 106 107 108 102 102 102 102 109 1 2 102 102 102 102 102 110 111 106 0 0 0 0 0 0 0 0 0 0 0 0 0 0 0 0 0 0 0 0 0 0 0 0 0 0 0 0 0
102 102 102 102 102 102 102 102 102 102 102 102 102 102 102 102 102 102 102 102 102 102 102 102 102 102 102 102 102 102 114 115 107 116 102 102 102 102 112 3 4 102 102 102 102 102 113 117 115 0 102 102 102 102 102 102 102 112 0 0 0 3075 3076 110 104 102 0 0 0 0 0 0 0 0 0 0 0 0 0 0 0 0 0 0 0 0 0 0 0 0 0 0 0 0 0 0 114 115 107 116 102 102 102 102 112 3 4 102 102 102 102 102 113 117 115 0 0 0 0 0 0 0 0 0 0 0 0 0 0 0 0 0 0 0 0 0 0 0 0 0 0 0 0 0
102 102 102 102 102 102 102 102 102 102 102 103 104 102 102 102 102 102 102 102 102 102 102 102 102 102 102 102 102 102 0 118 119 108 102 102 102 102 112 5 6 102 102 102 102 102 110 0 118 120 102 102 102 102 102 102 102 112 0 0 0 3077 3078 113 102 102 0 0 0 0 0 0 0 0 0 0 0 0 0 0 0 0 0 0 0 0 0 0 0 0 0 0 0 0 0 0 0 118 119 108 102 102 102 102 112 5 6 102 102 102 102 102 110 0 118 120 0 0 0 0 0 0 0 0 0 0 0 0 0 0 0 0 0 0 0 0 0 0 0 0 0 0 0 0
102 102 102 102 102 102 102 102 102 102 102 102 102 102 102 102 102 102 102 102 102 102 102 102 102 102 102 102 102 102 105 106 107 116 102 102 102 102 112 1 2 102 102 102 102 102 113 111 106 0 102 102 102 102 102 102 0 0 0 0 0 3073 3074 110 107 102 102 121 0 0 0 0 0 0 0 0 0 0 0 0 0 0 0 0 0 0 0 0 0 0 0 0 0 0 0 0 105 106 107 116 102 102 102 102 112 1 2 102 102 102 102 102 113 111 106 0 0 0 0 0 0 0 0 0 0 0 0 0 0 0 0 0 0 0 0 0 0 0 0 0 0 0 0 0
102 102 102 102 102 102 102 102 102 102 102 102 102 102 102 102 102 102 102 102 102 102 102 102 102 102 102 102 102 102 114 115 0 108 102 102 102 102 103 3 4 102 102 102 102 102 110 122 115 0 102 102 102 102 102 102 0 0 0 0 0 3075 3076 123 124 125 126 0 0 0 0 0 0 0 0 0 0 0 0 0 0 0 0 0 0 0 0 0 0 0 0 0 0 0 0 0 114 115 0 108 102 102 102 102 103 3 4 102 102 102 102 102 110 122 115 0 0 0 0 0 0 0 0 0 0 0 0 0 0 0 0 0 0 0 0 0 0 0 0 0 0 0 0 0
102 102 102 102 102 102 102 102 102 102 102 102 102 102 102 102 102 102 102 102 102 102 102 102 102 102 102 102 102 102 0 118 127 116 102 102 102 102 102 5 6 102 102 102 102 102 113 112 118 120 102 102 102 102 102 102 102 102 102 0 0 3077 3078 128 129 130 131 0 0 0 0 0 0 0 0 0 0 0 0 0 0 0 0 0 0 0 0 0 0 0 0 0 0 0 0 0 0 118 127 116 102 102 102 102 102 5 6 102 102 102 102 102 113 112 118 120 0 0 0 0 0 0 0 0 0 0 0 0 0 0 0 0 0 0 0 0 0 0 0 0 0 0 0 0
102 102 102 102 102 102 102 102 102 102 102 102 102 102 102 102 102 102 102 102 102 102 102 102 102 102 102 102 102 102 105 106 0 108 102 102 102 102 102 1 2 102 102 102 102 102 110 105 106 0 102 102 102 102 102 102 102 102 102 0 0 3073 3074 132 133 134 135 0 0 0 0 0 0 0 0 0 0 0 0 0 0 0 0 0 0 0 0 0 136 137 138 0 0 0 0 0 105 106 0 108 102 102 102 102 102 1 2 102 102 102 102 102 110 105 106 0 0 0 0 0 0 0 0 0 0 0 0 0 0 0 0 0 0 0 0 0 0 0 0 0 0 0 0 0
102 102 102 102 102 102 102 102 102 102 102 102 102 102 102 102 102 102 102 102 102 102 102 102 102 102 102 102 102 102 114 115 107 116 102 102 102 102 102 3 4 102 102 102 102 102 113 117 115 0 102 102 102 102 102 102 102 102 102 0 0 3075 3076 139 140 141 142 0 0 0 0 0 0 0 0 0 0 0 0 0 0 0 0 0 0 0 0 0 143 144 145 0 0 0 0 0 114 115 107 116 102 102 102 102 102 3 4 102 102 102 102 102 113 117 115 0 0 0 0 0 0 0 0 0 0 0 0 0 0 0 0 0 0 0 0 0 0 0 0 0 0 0 0 0
102 102 102 102 102 102 102 102 102 102 102 102 102 102 102 102 102 102 102 102 102 102 102 102 102 102 102 102 102 102 0 118 120 108 102 102 102 102 102 5 6 102 102 102 102 102 110 146 118 120 0 0 0 0 0 0 0 0 0 0 0 3077 3078 147 148 149 150 0 0 0 0 0 0 0 0 0 0 0 0 0 0 0 0 0 0 0 0 0 151 152 153 0 0 0 0 0 0 118 120 108 102 102 102 102 102 5 6 102 102 102 102 102 110 146 118 120 0 0 0 0 0 0 0 0 0 0 0 0 0 0 0 0 0 0 0 0 0 0 0 0 0 0 0 0
102 102 102 102 102 102 102 102 102 102 102 102 102 102 102 102 102 102 102 102 102 102 102 102 102 102 102 102 102 102 105 106 107 116 102 102 102 102 102 1 2 102 102 102 102 102 113 111 106 0 0 0 0 0 0 0 0 0 0 0 0 3073 3074 154 155 156 157 0 0 0 0 0 0 0 0 0 0 0 0 0 0 0 0 0 0 0 0 0 158 159 160 0 0 0 0 0 105 106 107 116 102 102 102 102 102 1 2 102 102 102 102 102 113 111 106 0 0 0 0 0 0 0 0 0 0 0 0 0 0 0 0 0 0 0 0 0 0 0 0 0 0 0 0 0
102 102 102 102 102 102 102 102 102 102 102 102 102 102 102 102 102 102 102 102 102 102 102 102 102 102 102 102 102 102 114 115 0 161 162 163 164 102 102 3 4 102 102 165 166 167 168 114 115 0 0 0 0 136 137 138 0 0 0 0 0 3075 3076 169 170 171 0 0 0 0 0 0 0 0 0 0 0 0 0 0 0 0 0 0 0 0 0 0 172 173 174 0 0 0 0 0 114 115 0 161 162 163 164 102 102 3 4 102 102 165 166 167 168 114 115 0 0 0 0 0 0 0 0 0 0 0 0 0 0 0 0 0 0 0 0 0 0 0 0 0 0 0 0 0
102 102 102 102 102 102 102 102 102 102 102 102 102 102 102 102 102 102 102 102 102 102 102 102 102 102 102 102 102 102 0 118 127 175 176 177 178 102 102 5 6 102 102 179 180 181 182 112 118 120 0 0 0 143 144 145 0 0 0 0 0 3077 3078 183 184 185 186 0 0 0 0 0 0 0 0 0 0 0 0 0 0 0 0 0 0 0 0 0 0 187 54373 52322 0 0 0 0 0 118 127 175 176 177 178 102 102 5 6 102 102 179 180 181 182 112 118 120 0 0 0 0 0 0 0 0 0 0 0 0 0 0 0 0 0 0 0 0 0 0 0 0 0 0 0 0
102 102 102 102 102 102 102 102 102 188 11 11 102 102 102 102 102 102 102 102 102 102 102 102 102 102 102 102 102 102 105 106 0 189 190 191 192 102 102 1 2 102 102 193 194 195 196 197 106 0 0 0 0 151 152 153 0 0 0 0 0 3073 3074 198 155 156 0 0 0 0 0 0 0 0 0 0 0 0 0 0 0 0 0 0 0 0 0 0 50271 1099 1100 1101 1099 49245 0 0 105 106 0 189 190 191 192 102 102 1 2 102 102 193 194 195 196 197 106 0 102 102 102 102 102 102 102 102 102 188 102 102 102 102 102 102 102 102 102 102 102 102 102 102 102 102 102 102
102 102 102 102 102 102 112 112 0 12 13 14 15 16 107 102 102 102 102 109 102 102 11 11 102 102 102 102 102 102 114 115 199 200 201 202 203 102 102 204 205 167 206 207 208 209 210 211 115 0 0 0 0 158 159 160 0 0 0 0 0 3075 3076 212 170 171 0 0 0 0 136 137 138 0 0 0 0 0 0 0 0 0 0 0 0 0 0 0 1102 1096 1049 1050 1096 1103 0 0 114 115 199 200 201 202 203 102 102 204 205 167 206 207 208 209 210 211 115 0 102 102 102 102 102 102 112 112 0 213 214 215 216 217 107 102 102 102 102 109 102 102 102 102 102 102 102 102
218 102 11 11 11 102 103 112 17 18 19 20 21 22 107 102 102 102 102 112 0 12 13 14 15 16 107 102 102 218 0 118 120 219 220 221 222 102 102 223 180 181 224 225 226 227 228 229 118 120 0 0 0 172 173 174 0 0 9 10 230 3079 3080 231 232 233 0 0 0 0 143 144 145 0 0 0 0 0 0 0 0 0 0 0 0 0 0 0 23 24 25 26 27 28 0 0 0 118 120 219 220 221 222 102 102 223 180 181 224 225 226 227 228 229 118 120 218 102 102 102 102 102 103 112 234 235 236 237 238 239 107 102 102 102 102 112 0 213 214 215 216 217 107 102
0 29 30 31 32 33 0 34 35 36 37 38 39 40 41 102 102 102 102 112 17 18 19 20 21 22 107 102 102 107 105 106 240 241 242 243 136 137 138 244 245 195 246 247 248 249 250 251 106 0 136 137 138 0 187 54373 53347 1099 4105 4106 1104 1099 1104 1099 1104 1099 0 0 0 0 151 152 153 0 0 0 136 137 138 0 0 0 0 0 0 0 0 0 0 0 0 0 0 0 0 0 105 106 240 241 242 243 136 137 138 244 245 195 246 247 248 249 250 251 106 0 0 0 252 253 254 255 0 256 257 258 259 260 261 262 263 102 102 102 102 112 234 235 236 237 238 239 107 102
29 42 43 44 45 46 0 47 48 49 50 51 52 53 54 102 102 102 102 34 35 36 37 38 39 40 41 102 102 107 114 115 264 265 266 267 143 144 145 268 269 209 270 271 272 273 274 275 115 0 143 144 145 50272 1104 1100 1105 1097 3081 3082 1106 1050 1107 1050 1107 1097 0 0 0 0 158 159 160 0 0 0 143 144 145 0 0 0 0 0 0 0 230 276 277 0 0 0 0 0 0 0 114 115 264 265 266 267 143 144 145 268 269 209 270 271 272 273 274 275 115 0 0 278 279 280 281 282 0 283 284 285 286 287 288 289 290 102 102 102 102 256 257 258 259 260 261 262 263 102
55 56 57 58 59 60 291 102 292 293 294 295 296 297 102 102 102 102 102 47 48 61 62 63 64 53 54 102 102 218 0 118 120 116 298 299 151 152 153 300 301 302 303 229 304 305 306 112 118 120 151 152 153 1108 1107 1050 1107 1097 3081 3082 1106 1049 1096 1049 1096 1097 0 0 0 0 172 173 174 0 0 0 151 152 153 0 0 0 0 0 65 50272 1104 1099 1104 1104 49246 66 0 0 0 0 0 118 120 116 298 299 151 152 153 300 301 302 303 229 304 305 306 112 118 120 307 308 309 310 311 312 291 102 292 293 294 295 296 297 102 102 102 102 102 283 284 313 314 315 316 289 290 102
67 68 69 70 71 317 318 102 319 320 321 322 323 324 325 325 325 218 109 102 326 295 296 327 328 329 102 102 102 107 105 106 240 5210 51297 330 158 159 160 331 332 53348 5211 333 334 53348 5212 251 106 0 158 159 160 23 24 25 72 73 3081 3082 1106 1050 1107 1050 1107 1097 0 0 0 0 0 187 0 0 0 0 158 159 160 0 0 0 0 0 50271 1108 1107 1107 1050 1050 1109 49245 0 0 0 0 105 106 240 5210 51297 330 158 159 160 331 332 53348 5211 333 334 53348 5212 251 106 0 335 336 337 338 339 317 318 102 319 320 321 322 323 324 325 325 325 218 109 102 326 295 296 327 328 329 102 102
102 340 341 342 343 344 65 50272 1099 1104 1099 1104 1099 1104 1099 1104 1099 49245 345 346 347 322 323 348 349 350 325 325 351 107 117 115 264 352 266 267 172 173 174 3 4 273 353 354 272 273 355 275 115 0 172 173 174 0 0 0 32850 32841 3081 3082 1106 1049 1096 1049 1096 1097 0 0 0 65 50272 1099 51294 66 0 0 172 173 174 0 0 0 74 50272 1102 1096 1096 1096 1049 1096 1110 1103 49246 66 0 0 117 115 264 352 266 267 172 173 174 3 4 273 353 354 272 273 355 275 115 0 102 340 341 342 343 344 65 50272 1099 1104 1099 1104 1099 1104 1099 1104 1099 49245 345 346 347 322 323 348 349 350 325 325
346 356 341 357 358 359 50271 1108 1107 1050 1107 1050 1107 1050 1107 1050 1096 1111 1099 1104 1099 1104 1099 1104 1099 1104 1099 1104 1099 49245 360 361 362 363 364 365 102 187 230 7 8 366 367 276 368 369 370 371 372 373 374 375 376 277 0 0 32850 32841 3081 3082 1106 1050 1107 1050 1107 1097 0 0 0 50271 1108 1050 1112 49245 0 0 0 187 0 0 0 54373 53347 1108 1107 1107 1050 1107 1050 1107 1113 1113 1109 49245 0 0 360 361 362 363 364 365 102 187 230 7 8 366 367 276 368 369 370 371 372 373 346 356 341 357 358 359 50271 1108 1107 1050 1107 1050 1107 1050 1107 1050 1096 1111 1099 1104 1099 1104 1099 1104 1099 1104 1099 1104
1104 1099 1104 1099 1104 1099 1102 1049 1107 1050 1096 1049 1107 1050 1096 1049 1049 1096 1107 1050 1049 1096 1107 1050 1049 1049 1107 1050 1049 1111 1104 1099 1104 1099 1104 1099 1104 1099 1104 1099 1104 1099 1104 1099 1104 1099 1104 1099 1104 1099 1104 1099 1104 1099 1104 1099 1096 1049 1104 1099 1096 1049 1096 1049 1096 1049 1104 1099 1104 1102 1096 1049 1096 1111 1104 1099 1099 1104 1099 1104 1099 1100 1105 1049 1096 1096 1049 1096 1049 1096 1049 1096 1096 1111 1104 1099 1104 1099 1104 1099 1104 1099 1104 1099 1104 1099 1104 1099 1104 1099 1104 1099 1104 1099 1104 1099 1104 1099 1104 1099 1104 1099 1102 1049 1107 1050 1096 1049 1107 1050 1096 1049 1049 1096 1107 1050 1049 1096 1107 1050 1049 1049 1107 1050
1107 1050 1107 1050 1107 1050 1107 1050 1096 1049 1107 1050 1096 1049 1107 1107 1050 1050 1096 1049 1107 1050 1107 1050 1107 1050 1096 1049 1096 1096 1107 1050 1107 1050 1107 1050 1107 1050 1107 1050 1107 1050 1107 1050 1107 1050 1107 1050 1107 1050 1107 1050 1107 1050 1107 1050 1107 1050 1107 1050 1107 1050 1107 1050 1107 1050 1107 1050 1107 1050 1107 1050 1107 1050 1096 1107 1096 1107 1050 1107 1050 1107 1050 1096 1096 1107 1050 1107 1050 1107 1107 1050 1107 1050 1107 1107 1107 1050 1107 1050 1107 1050 1107 1050 1107 1050 1107 1050 1107 1050 1107 1050 1107 1050 1107 1050 1107 1050 1107 1050 1107 1050 1107 1050 1096 1049 1107 1050 1096 1049 1107 1107 1050 1050 1096 1049 1107 1050 1107 1050 1107 1050 1096 1049
1096 1049 1107 1050 1096 1049 1107 1050 1096 1049 1107 1050 1096 1049 1096 1096 1049 1049 1096 1049 1096 1049 1096 1049 1107 1050 1096 1049 1107 1050 1096 1049 1096 1049 1096 1049 1096 1049 1096 1049 1096 1049 1096 1049 1096 1049 1096 1049 1096 1049 1096 1049 1096 1049 1096 1049 1096 1049 1096 1049 1096 1049 1096 1049 1096 1049 1096 1049 1096 1049 1096 1049 1096 1049 1049 1096 1049 1096 1049 1096 1049 1096 1049 1096 1049 1096 1049 1096 1049 1096 1096 1049 1096 1049 1096 1049 1096 1049 1096 1049 1096 1049 1096 1049 1096 1049 1096 1049 1096 1049 1096 1049 1096 1049 1096 1049 1096 1049 1107 1050 1096 1049 1107 1050 1096 1049 1107 1050 1096 1049 1096 1096 1049 1049 1096 1049 1096 1049 1096 1049 1107 1050 1096 1049
