22 15
35 36 37 35 36 38 39 40 41 40 41 40 41 42 43 44 45 46 44 45 1024 0
47 48 49 50 51 52 53 54 55 56 57 58 59 60 61 47 48 49 50 51 1024 0
62 63 64 65 66 67 68 69 70 71 72 73 74 75 76 62 63 64 65 66 1024 0
77 78 79 80 81 82 83 84 85 86 87 88 89 90 91 77 78 79 80 81 1024 0
92 93 94 95 96 97 98 99 100 101 102 103 104 105 106 107 93 94 95 108 1024 0
109 110 111 112 113 114 115 116 117 118 119 120 121 122 123 124 110 111 112 125 1024 0
126 127 94 128 129 130 131 132 133 134 135 136 137 138 139 140 127 94 128 141 1024 0
142 143 144 145 146 147 148 149 150 151 152 153 154 155 156 157 143 144 145 158 1024 0
159 159 160 161 162 163 164 165 166 167 168 169 170 171 172 173 174 160 0 0 1024 0
159 159 160 175 176 177 178 179 180 181 182 183 184 185 186 187 188 160 0 0 1024 0
15 12 189 3 190 191 192 193 194 195 196 197 10 198 199 200 18 201 15 12 1024 0
1025 1026 1027 1028 1029 1030 1031 1032 1033 1034 1035 1036 1037 1038 1039 1040 1041 1042 1043 1044 1024 0
1045 1046 1047 1045 1048 1049 1050 1051 1052 1050 1053 1052 1054 1055 1056 1054 1055 1056 1057 1058 1024 0
0 0 0 0 0 0 0 0 0 0 0 0 0 0 0 0 0 0 0 0 0 0
0 0 0 0 0 0 0 0 0 0 0 0 0 0 0 0 0 0 0 0 0 0
